++++++++++++++++++++++++++++++++++++++++++++++++++++
++   +       +       +   +   +                   + +
++ +++ + +++ +++ +++ + +++ + +++++++++++++ +++++ + +
++     +   +     +     +   +     +         +       +
++++++++++ +++++++ +++++ +++++++ + +++++++++ +++++++
++       + +   +     +   + +   + + +   +   +   +   +
++ +++++ + + + + +++++ +++ + + + + + +++ + + +++ + +
++ +     + + +   +   +   +   +   + +   + +   +   + +
++ +++ +++ + +++++ + +++ + +++++++ + + + +++++ +++ +
++   + +   + +     +     + +       + +   +   +   + +
++ + + +++ + + +++++++++++ + +++++ + +++++ + +++ + +
++ + +     + +   +       + +   +   + +     +   + + +
++ + +++++++ +++ +++++ +++ +++++ +++++ +++++ +++ + +
++ +   +   +   +     +   +     +       +   +   + + +
++++++ + + + +++++++ + + +++++ +++ +++++ + +++ + + +
++     + + + +     + + +   + +   +       + +   + + +
++ +++++ +++ + + +++ + + + + +++ +++++++++++ +++ + +
++ +       + + + +s  + + +     +           + +   + +
++ +++++++ + + + +++++++ + +++++++++++++++ + + +++ +
++ +     +   + +   +     + +       +       + + + + +
++ + +++ +++++ + +++ + +++++ +++++ + +++++++ + + + +
++ + + + +     +     +   +   +   +   +   +   + + + +
+e + + + + +++++++++++++ + +++ + +++++ + + +++ + + +
++ + + +   +       +     +   + +       + +       + +
++ + + +++++ +++++ + +++++++ +++++++++ + + +++++ + +
++   +       +   + +   +     +         + + +   + + +
++ +++ + +++++++ + +++ + +++++ +++++++++ + + + +++ +
++ +   + +       + + + + +     +     +   + + +     +
++ +++++ + + +++++ + + + + +++++ +++ + +++++ +++++ +
++       + +         +     +       +         +     +
++++++++++++++++++++++++++++++++++++++++++++++++++++
++++++++++++++++++++++++++++++++++++++++++++++++++++