++++++++++++++++++++++++++++++++++++++++++++++++++++
++     +           +       +     +         +       +
++ +++ + +++++ +++ +++++ + + +++++ +++ +++ + +++++ +
++ +   +     +   +       + + +     + + +     +   + +
++++ +++++++ +++ +++++++++ + + +++++ + +++ +++ + +++
++   +     + +   +   +   + + +       +   + +   +   +
++ +++ +++ + + +++ + + + + + +++ +++++++ + + +++++ +
++ +     + + +   + + + +   +   + +       + +   +   +
++ + +++++ + +++ + +++ +++++++ + + +++++++ +++ + +++
++   +   + + + + +           +   + +       +   + + +
++ +++ + + + + + + +++++++++ + +++ +++++++++ +++ + +
++   + +   +   + +   +   +   + +   +   +     +   + +
++++++ + +++++ + +++++ + + +++++ +++ + + +++++ +++ +
++     + +   + +     + + +       +   +   + +s  +   +
++ +++++++ + + +++++ + + +++++++ + +++++++ +++++++ +
++     +   + + + +   + + +       + +   +           +
++ +++ + +++ + + + +++ + +++++++++ + + + +++++++++ +
++ +   +   +   + +     + +       +   +   +         +
++++ + +++ +++++ +++++++ + +++++ +++++++++ +++++++++
++   +   +     +   + +   +     +       + +   +     +
++ +++++ +++++ + + + + + +++++ + +++++ + +++ + +++ +
++ +   + +   + + +   + + +   + + +         + +   + +
++ +++ + +++ + + +++ + + +++ + + +++++++++ + +++++ +
++ +   +   + + + +   + + +   + +   +     + +       +
++ + +++++ + + + +++++ + + + + +++ + +++ + +++++++ +
++ +         + +   +   + + + +   + + +   + +     + +
++ +++++++++++ + + + +++ + +++++ + + + +++ + +++ + +
++ +         + + e +   +   +   + + + +   + +   +   +
++ + +++++++ + +++ +++ +++++ + + + + +++ +++++ +++++
++         +         +       +   +     +           +
++++++++++++++++++++++++++++++++++++++++++++++++++++
++++++++++++++++++++++++++++++++++++++++++++++++++++