++++++++++++++++++++++++++++++++++++++++++++++++++++
+     +       +       +s+ +     +       + +       ++
+ +++ +++ +++++ +++ +++ + + + + + +++++ + + + +++ ++
+ +       +   +   + +   +   + + +     + +   +   + ++
+ +++++++++ + +++ + + +++++++ + + +++ + +++++ + + ++
+         + +   + +   +       + + +   + +   + + + ++
+ +++++++ + + + + +++++ +++++++ +++ +++ + + +++ + ++
+ + +     + + + + + + e +     +   +   +   +     + ++
+ + + +++++ + +++ + + + + + + +++ +++ +++++++++++ ++
+ + + +     + +   +   + + + +   +   + +     +     ++
+ + + + +++++ + +++++++ +++ +++ +++ + + +++ + ++++++
+ + + + + +   + +     +   + +   + +   + +   +   + ++
+ + + + + + +++ + + + +++ + + +++ +++++++ + +++ + ++
+   +   + +   + + + +     + +   +         +   + + ++
+++ +++++ +++ + +++ +++++++ +++ +++ +++ + +++++ + ++
+ + +       +   +   +   +   + +   +   + + +   +   ++
+ + + +++++ +++++ +++ + + + + +++ +++++ + + + +++ ++
+ + + +   + +     +   + + + +           + + +   + ++
+ + + + +++ + +++ + + +++ + +++++++++++++++ +++ + ++
+ + + + +   + +   + +   + + +   +           + + + ++
+ + + + + +++ + +++++++ + + + + + +++++++++++ + + ++
+ +   +   + + + +       + +   + +       +     +   ++
+ +++++ +++ + + +++ +++ + +++++ +++++++ +++ + ++++++
+     + + +   +   +   + +     +   +   +   + +     ++
+ +++++ + + +++++ + + + +++ +++ +++ + +++ + + +++ ++
+ +     +       + + + + +   +   +   + +   + + +   ++
+ + +++++ +++++++ + + + + +++ +++ +++ + +++++ + ++++
+ + +       +   + + + + + + +   + + + + +   + + + ++
+ + +++++++++ + + + + +++ + +++ + + + + + + + + + ++
+             +   + +         +     +     +   +   ++
++++++++++++++++++++++++++++++++++++++++++++++++++++
++++++++++++++++++++++++++++++++++++++++++++++++++++