++++++++++++++++++++++++++++++++++++++++++++++++++++
++++++++++++++++++++++++++++++++++++++++++++++++++++
++         +     +                       +     +   +
++ +++++++ + +++ +++++++ +++++++++++ +++ +++ + +++ +
++ +   + + +   +       +   +   +     + + +   +     +
++ + + + + + + +++++++ +++++ + + +++++ + + +++++++ +
++   +s+   + + +     +     + + +   +     +   +   + +
++++++++ +++ + + +++ +++++ + + +++ + +++++ + + + +++
++     + + + + e +     +   + +     + +   + +   +   +
++ + +++ + + + + +++++ + +++ +++++++ + +++ +++++++ +
++ + +   +   + +   + + +   + +     + +           + +
++ + + +++ +++ +++ + + +++ + + +++ + +++++++++++++ +
++ + + +     + +   +     +   +   + + +           + +
++ + + +++++++ + +++++++++++++++ + + + +++++++++ + +
++ + +   +   + + +     +     +   +   + + +     +   +
++ +++++ + + + + + +++ + + +++ +++++++ + + +++ +++ +
++     +   + + +     +   + +   +       +   +     + +
++ +++ +++++ + + +++++++ + + +++ +++ +++++ + +++++ +
++   +     +   +   +   + + +   + +   +   + +       +
++ +++ +++ +++++++++ + +++ +++ + +++++ + +++ +++++++
++ +   +             +   +   + +     + +   + +     +
++ + +++++++++++++++++++ + +++ +++++ + +++ + +++ +++
++ + +       +   +     + + +   +   + + + + +   +   +
++++ + +++++ +++ + +++ + + + +++ + + + + + +++ +++ +
++   + +   +   +     +     + +   + +     +   +     +
++ +++ + + +++ +++++++++++ + + +++ + +++++++ +++++ +
++ +   + +   +     +   +   + +   + + +     +   + + +
++ + +++ +++ +++++ + + + +++ +++ + + + +++ +++ + + +
++ + +     +     +   + +   +     + + + + + +   + + +
++ + +++++++++++ +++++ +++++++++++ +++ + + + +++ + +
++                   +                 +     +     +
++++++++++++++++++++++++++++++++++++++++++++++++++++