++++++++++++++++++++++++++++++++++++++++++++++++++++
++++++++++++++++++++++++++++++++++++++++++++++++++++
+     +   +     + +       +       +       +       ++
+ +++ + + +++ + + + + +++ +++++ + +++++ +++ +++++ ++
+   +   +   + + +   + +   +     +     + +       + ++
+++ +++++++ + + +++ + +++ + +++++++++ + + +++++++ ++
+   +         +   + +   + +       +   +     +   + ++
+ +++++++ +++++++ + +++ + + +++++ + +++++++++ + + ++
+ +     + +   + + + +   + +   +   +           +   ++
+ + +++ + + + + + + + +++ + +++ +++++++++ ++++++++++
+     + + + + +   + + +   + +   + +   +   +       ++
+ +++++ + + + + +++++ + +++++ +++ + + + +++ +++++ ++
+   +   + + + +     + +     + + +   +   +   + +   ++
+++ + +++++ + +++++ + +++++ + + + +++++++ +++ + ++++
+ + +       +     +   +       +   +       +   +   ++
+ + +++++++++++++ + +++++ +++++++++ +++++++ + +++ ++
+ +         +   + + +   + + +     + +   +   + +   ++
+ +++++++++ + + + +++ + + + + +++ + + + + +++ + ++++
+         +   + +   + + +   + + + +   +   +   +   ++
+ +++++ + +++++ +++ + + +++++ + + + +++++++++++++ ++
+ +   + +     + +   + +   +   + +   +           + ++
+ e + + +++++++ + +++ +++ + +++ +++++ +++++++++ + ++
+ + + +     +   + +   +   + +     +   +s+     + + ++
+ +++ +++++ + +++ + +++ +++ + +++++ +++ + + + + + ++
+   +     +     + + +   +   +   +   +   + + + + + ++
+++ +++ + +++++++ + + + + +++++ + +++ +++ + + + + ++
+ +   + +   +     + + + + +     +     +   + + +   ++
+ +++ + +++++ +++++ + +++ + +++ +++++++++++ + ++++++
+   + +     + +     +   +   +   +           + +   ++
+ + + +++++ + + +++++++ +++++ +++++++++ +++++ + + ++
+ +         +         +                 +       + ++
++++++++++++++++++++++++++++++++++++++++++++++++++++