++++++++++++++++++++++++++++++++++++++++++++++++++++
+   + +   +       +     +         +           +   ++
+ + + + + + +++++ + + +++ +++++++ + +++++++ + +++ ++
+ +   + +   +     + + +     +   +   + +   + +   + ++
+ +++++ +++++ +++++ + + +++++ + +++ + + + + +++ + ++
+     + +   +   +   + + +     +   +   + + + + +   ++
+ +++ + +++ +++ + +++ + + +++++++ +++++ + + + +++ ++
+ +   +       +     +   +   +   +       +   +   + ++
+++ + + +++++++++++++ +++++ + + +++++++++++++ +++ ++
+   + + +           + + +   + +   +     +         ++
+ +++++ + +++++++++ + + + +++ +++ + + + + ++++++++++
+       +     +   + +   +     + + + + + + +       ++
+ +++++++++++ + + + +++ +++++++ + + + +++ + +++++ ++
+ +           + +   +       +   + + +   + +   +   ++
+ + +++++++++++ +++++ +++++ +++ + +++++ + + +++ + ++
+ + +         +   +   +   +     +     + + + +   + ++
+ + +++++ + +++++ +++++ + +++++ +++++ + + + + +++ ++
+ +     + +     +       +   + + + +   +   + + +   ++
+ +++++ +++ +++ +++++++++++ + + + + +++ +++ + + ++++
+ +   +   +   +           + +     + +   +   + +   ++
+ + +++++ +++++++++++ + +++ +++++++ + +++ +++ +++ ++
+   +     +           + +   +     + + +   +   + + ++
+++ + +++++ +++++++++++++ +++ +++ + + +++++ +++ + ++
+   + + +       +       + +   +   + +       +   + ++
+++++ + + +++++ + +++++ + +++ + +++ +++++++++ +++e++
+     + + +   + +   + +   +   +     +             ++
+ +++++ + + + + +++ + +++++ +++++++++ ++++++++++++++
+ +       + + +           +   + +     +     +     ++
+ +++++++++ + +++++++++++ +++ + + +++++ +++ +++ + ++
+           +        s+       +         +       + ++
++++++++++++++++++++++++++++++++++++++++++++++++++++
++++++++++++++++++++++++++++++++++++++++++++++++++++