++++++++++++++++++++++++++++++++++++++++++++++++++++
+ +       +     +       +     +e          +       ++
+ + + +++ +++++ + + +++ +++++ + +++++ +++ + +++ + ++
+ + +   +     +   + +   +   +     +   + + + + + + ++
+ + +++ +++++ +++++ + +++ + +++++++ +++ + + + + + ++
+   +   +   +   +   +     +         +     +   + + ++
+ +++ +++ + +++ + +++++++++++++++++++ +++++++ + ++++
+ +   +   +   +   +   +     +   +     +       +   ++
+++ +++ +++ +++++++ +++ + + + + + +++++ +++++++++ ++
+   +     +   +       + + +   + + +     +         ++
+ +++++++ +++ + +++++ + + +++++ + +++++++ +++++++ ++
+       +   +     +   + +   +   +   +   + +   +   ++
+ +++++ +++++ +++++ +++ +++ +++ +++ + + + +++ + ++++
+     +     + + +   +     +   +   + + + +   +   + ++
+++++++++++ + + + +++ +++++++ + +++ + + +++ + +++ ++
+   +     + +   +     +     + + +   + +     +   + ++
+ + + +++ + +++ +++++++ +++ + +++ +++ +++++++++ + ++
+ +   + +   + +     + +   + +   +     +   +   + + ++
+ +++++ +++++ +++++ + +++ + +++ +++++++ + + + + + ++
+     +             +   + +     +       +   + + + ++
+++++ +++++++++ +++++ +++ +++++ + +++++ +++++++ + ++
+   +   +    s+ +       +     + +     +       +   ++
+ +++++ + +++++ +++++++ +++++ +++++++ +++++++ +++ ++
+     + +   + +       +     +       + + +   +     ++
+ + + + +++ + +++++++ +++ + +++++++ + + + + ++++++++
+ + + +     +       +   + +   +   +   +   +       ++
+++ +++++++++ + +++++++ + +++ + + +++++++++ +++ + ++
+   +       + +     +   + + + + +         +   + + ++
+ +++ +++ +++ +++++ + +++ + + + +++++++++ +++++ + ++
+       +         +       +     +               + ++
++++++++++++++++++++++++++++++++++++++++++++++++++++
++++++++++++++++++++++++++++++++++++++++++++++++++++