++++++++++++++++++++++++++++++++++++++++++++++++++++
++++++++++++++++++++++++++++++++++++++++++++++++++++
+ +     +   +   +     +       +     +         +   ++
+ + +++ + + + + + + + + + +++ +++++ + + +++++ +++ ++
+   +   + +   +   + + + +   + +     + + +   + +   ++
+++++ + + +++++++++ + +++++ + + +++ + +++ + + + + ++
+   + + + +   +   + +       +   +   +     + +   + ++
+ + + +++ + + +++ + +++++++++++++++++++++++ +++++ ++
+ +   +   + +   + + +       +         +   + + +   ++
+ +++++ +++ +++ + + + +++++ + +++++++ + + + + + ++++
+     +   + +     + + + +   +   +   + + +   + +   ++
+ +++ +++ + + +++++ + + + +++++ + + + + +++++ +++ ++
+ +     +   + +     + + +     + + +   +     + +   ++
+++ +++ +++ +++ +++++ + +++ + + + +++++++++ + + ++++
+   +   +   +   +         + + + +     +     + +   ++
+ +++++++ +++ + + +++++++++ + + +++++ + +++++ +++ ++
+       + +   + + +   +   + + + +   +e+   +     + ++
+++++++ + + +++++ +++ + + + + + + + + +++ + +++++ ++
+     +   + +     +   + +   + +   + + +   +       ++
+ +++ +++ + + +++++ + + +++++ + +++++ + +++ ++++++++
+ + +   + + + +     + +   +   + +     + + + +     ++
+ + +++ +++ + + +++++ +++ +++++ + +++ + + + +++++ ++
+ +         +   + +     + +   + +   + +s+   +   + ++
+ +++++++ +++++++ + +++++ + + + +++ + +++ +++ + + ++
+       + +       + +   + + +   +   + + +   + + + ++
+ +++++ +++ +++++ + + + + + +++++ +++ + +++ + + + ++
+ + +   +   +   +   + +   + + +   + +     +   + + ++
+ + + +++ +++++ +++++ +++++ + + +++ +++ +++++++ + ++
+   +   +   +     + +     + + +   +     +   +   + ++
+++ +++ +++ + +++ + +++++ + + +++ +++++++ + + +++ ++
+     +       +         +       +         +       ++
++++++++++++++++++++++++++++++++++++++++++++++++++++