++++++++++++++++++++++++++++++++++++++++++++++++++++
++++++++++++++++++++++++++++++++++++++++++++++++++++
+     +     +   +   +     +               +       ++
+ +++ +++ + +++ + + + +++ + +++ +++++++++ + +++++ ++
+   + +   +     + +   +   +   +   +     + +     + ++
+ + + + + +++++ + +++++ +++++ +++ + +++ + +++ +++ ++
+ + +   + +   + +     +       + +   +   +   + +   ++
+ + +++++ + + +++++++ +++++++++ +++++ +++++ + + ++++
+ +   +   + + +   +   +       +   +   +   + + +   ++
+ +++ +++ + + + + + +++ +++++ +++ + +++++ + +++++ ++
+ + +   + + +  e+ + +   +   +     +     + +       ++
+ + +++ +++ +++++ + +++ +++ +++ +++++++ + + ++++++++
+     +     +   + +     +     + +   +   +   +     ++
+++++ +++++++ + + +++++++ +++++ + + + +++++++ +++ ++
+     +       + +   +   +       + + +         + + ++
+ +++++ +++++ + +++ + + + +++++++ + + +++++++ + + ++
+ +   + +   + +   + + +     +     + +   +   +   + ++
+ + + +++ + + +++ + + +++++++ +++++ +++++ + +++++ ++
+   + +   + + +   +   +   +   +           + +   + ++
+++++ + +++ + +++++++++ + + +++++ +++++++++ + + + ++
+   + + + + + +       + + + +   + +      s+ + + + ++
+ + + + + + + + +++ + +++ + + + +++ +++++++ + + + ++
+ + +   +   + +   + +     + + + +   +     + + + + ++
+ + +++++ +++ + +++ +++++ + + + + +++++++ + + + + ++
+ +   +   +     +   + +   +   +   +       +   +   ++
+ +++ + +++ +++++ +++ + +++++++++++ +++++ ++++++++++
+   + +   + +     +   +       +     +     +       ++
+++ +++++ +++ +++++ + +++++++ +++++ + +++++++ +++ ++
+   +   +   + +     + +     + +   + + +     + +   ++
+ +++ + +++ + + +++++ + +++ + + + + + + +++ + + ++++
+     +       +     +     +     +   +   +     +   ++
++++++++++++++++++++++++++++++++++++++++++++++++++++