++++++++++++++++++++++++++++++++++++++++++++++++++++
++     +               +   +     +   +     +   +   +
++ + + + +++++++ +++++ +++ + + + + + + + + +++ + + +
++ + + +   +     +       +   + +   + + + +   +   + +
++++ + +++++ +++++ +++++ +++ + +++++ +++ +++ +++++ +
++   +       +   + +   +   + +   + +     +   +   + +
++ +++++++++++ + + + + +++ +++++ + +++++++ +++ + + +
++ + +         +   + + + + +     +       + +   +   +
++ + + +++++++++++++ + + + + +++++ +++++ + + + +++ +
++ +   +   +         + + +   +   +     + + + + + + +
++ +++++ + + +++++++++ + +++++ +++++++ + + + + + + +
++ +     +   +     +   +     +     +   +   + + +   +
++ + +++++++++ +++ + +++ +++ +++ + + +++++++ + + +++
++   +     +   +     +     +     + + +       + +   +
++ +++++++ + +++ +++++++ + +++++++ + +++++++++ +++ +
++ +       + +   +     + + +       +         + +   +
++ +++ +++ + +++++ +++ +++ +++++++++++++++++ + + +++
++     + + +         +   +   +     +         + + + +
++++++++ + +++++++++++++ + + + +++ + +++++++++ + + +
++   +   +   +   +       + + +   + + + +       +   +
++ +++ + +++ + + + +++++++ + +++ + + + + +++ +++++ +
++     +   +   + +   +     +   + +   + + +   +     +
++++++++++ +++++ +++ + +++++++ + +++++ + + +++ +++++
++     +       + +   + +       + +       +   +     +
++ +++ + + +++++ + +++ + +++++ + +++ +++++++ +++++++
++ +     + +   + + + + + +     +   +   e   +       +
++ +++++++++ + + + + + + + +++++++ +++++ +++++++++ +
++         + + + + +   + + +       +   + +       + +
++ +++++++ + + + + + +++ +++ +++++++ + +++ +++++ + +
++       +   +   +s+   +             +     +       +
++++++++++++++++++++++++++++++++++++++++++++++++++++
++++++++++++++++++++++++++++++++++++++++++++++++++++