++++++++++++++++++++++++++++++++++++++++++++++++++++
++++++++++++++++++++++++++++++++++++++++++++++++++++
++         e   +         +   +     +     +   +     +
++ + +++++++++++ + +++++ +++ + + +++ + + + + +++ + +
++ + +         + + +   +   + + +   + + +   +     + +
++ +++ +++++++ + + + + +++ + + +++ + + + +++++++++++
++   + +   +   + + + + +     + + +   + + +         +
++ + + + + + +++ + + + +++ +++ + +++++ +++ +++++++ +
++ +   + + +   + +   +   + +   +     +     +     + +
++ +++++ + +++ + +++++++ +++ +++ + +++++++++ +++ + +
++ +     +   +   +     + +   + + + +           + + +
++ + + +++++ +++++ +++++ + +++ + + + +++++ +++ +++ +
++ + +   +         +     + +     +   +   + +   +   +
++ +++++ +++++++++++ + +++ + +++++++++ + +++ + + +++
++     + +       +   + +   +       +   +     + +   +
++++++ + + +++++ + +++++ +++++++ +++ +++++++ +++++ +
++ +   + +   +   +     + +     + +   +     + +   + +
++ + +++ +++ + + +++++ + + +++ +++ +++ +++ +++ + + +
++ +   +     + +     +     + + +   +   +       + + +
++ +++ +++++++ +++++++++++++ + + + + +++++++++++ + +
++   +       + +         + +   + + +     +   + + + +
++ + + +++++ + + +++++++ + + +++ + +++++ + + + + + +
++ + + +   +   +       + +       +   +   + +   + + +
++ +++ + + +++ +++++++ + +++++++++++++ +++ +++++ + +
++     + +   +       + +               +       + + +
++++++++ +++ +++++++ + +++++++++++++++++ +++++ + + +
++       +     +   + + +   +   +   +   + +   + +   +
++ +++++++++++ + + +++ + + + + + + + + + + + + +++ +
++ +     +s  + + +   +   +   +   +   + + + + +     +
++ + +++ +++ + + +++ +++++++++++++++++ + +++ +++++++
++     +     +   +                     +           +
++++++++++++++++++++++++++++++++++++++++++++++++++++