++++++++++++++++++++++++++++++++++++++++++++++++++++
++ +               +         +           +         +
++ + +++++ +++++++ + + +++++ + +++++++++ + +++++ +++
++   +   +       + + +   +   +   +     +       +   +
++ +++++ +++++++ + + +++ +++++++ + +++ +++++++++++ +
++         + +   + +   +       + + +     +     +   +
++++++++++ + + +++++++ +++++++ + +++ +++ + +++e+ +++
++       + + +     +   +   + +   +   +   + + + +   +
++ + +++++ + +++++ + +++ + + +++++ +++ +++ + + +++ +
++ +     +       +   +   +   +     +     + +       +
++ +++++ +++++++ +++++ +++++ + + +++++++ + +++++++ +
++ +   +       + +     +   + + +     + + +   +     +
++ + + + +++++++ +++ +++ + + +++ +++ + + +++ + +++++
++   + +   +   +   + +   + +   + +   + + +   +     +
++++++ +++ + + +++ + + +++ +++ + + +++ + + +++++++ +
++       +   +   +   + +     + + + +   + +   +     +
++ +++++++++++ + +++++ + +++++ + + + + + +++ +++++++
++     +       +     + + +     + + + +     + +     +
++++++ + +++++++++ +++ + + +++++ + +++++++ + + +++ +
++     +       +   +   + + +     +     + + +   +s+ +
++ +++++++ +++ + +++ +++ + + +++++++++ + + +++++ + +
++ +     + +   + + +   + + +   +       + + +   +   +
++++ +++ +++ +++ + +++ + + +++++ +++++++ + +++ +++++
++   +       +     +   + +     +       +       +   +
++ +++++++++++ +++++ +++ +++++ + +++++ +++++++ + +++
++   +     +   +       +     + + +   +   + +   +   +
++ + + +++ +++ + +++++++ +++++ + + + +++ + + +++++ +
++ +   + +   + + + +     +     +   + +   +   +     +
++ +++++ +++ +++ + + +++++ +++++++++++ +++ +++++ + +
++         +       +                   +         + +
++++++++++++++++++++++++++++++++++++++++++++++++++++
++++++++++++++++++++++++++++++++++++++++++++++++++++