++++++++++++++++++++++++++++++++++++++++++++++++++++
+   +       +           + +     +       +       + ++
+ +++ +++ +++ +++++++ + + + +++ + +++++ +++ +++ + ++
+   + + +     +   +   +   + +     +     +   + +   ++
+ + + + +++++++ + + +++++++ +++++++ +++++ +++ +++ ++
+ + + +   +     + + +     +     +         + +     ++
+ + + + + + +++++ + + +++ +++++ +++++++++++ + ++++++
+ +   + + + +   + + + + +     +       +   + + +   ++
+ +++++++ + +++ + + + + +++++ +++++++ + + + + + + ++
+   +   + +   + + + + +   + +       +   + +   + + ++
+++ + + + +++ + + + + + + + +++++++ +++++ +++ +++ ++
+   + +     + + + + + + +   +     +     +   +   + ++
+ +++ +++++ + + + + + + +++ + + + +++ + +++ +++ + ++
+ +   +     + + + + +   +   + + + +   +   + + +   ++
+ + +++ +++++ + + + +++++ +++ + +++ +++++ + + +++ ++
+   + + + +   +   +     + +   + +   +     + +   + ++
+++++ + + + +++++ + +++++ + +++ + +++ +++++ + + + ++
+     + + + +   +   +   + + +   +   +   +   + + + ++
+ +++++ + + + + +++++ + + +++ + +++ +++++ +++ + + ++
+     +   +   +       + + +   + +   +     +   +   ++
+ +++ +++ +++++++++++++ + + + +++ +++ +++++ ++++++++
+ +     +     +         +   + +   +   +   + +     ++
+ + +++ +++++ + +++++++++++ +++ + + +++++ + +++++ ++
+ + +     +   +     +     + +   + +     + +       ++
+ + +++++++ +++++++ + + + + + +++++++++ + +++++++ ++
+ + +       +       + + + + +       +s  +     +   ++
+ + + +++++++ +++++ + + + + +++++ +++++++ +++ + ++++
+ +   +   + + +     + + + + +   + +   +   +   +   ++
+ +++++ + + + +++++++ + +++ + + + + + + +++ +++++ ++
+       +   +         +   e   + +   +     +       ++
++++++++++++++++++++++++++++++++++++++++++++++++++++
++++++++++++++++++++++++++++++++++++++++++++++++++++