++++++++++++++++++++++++++++++++++++++++++++++++++++
++                         +       +             + +
++ +++++ +++++++ +++++++++ +++ + + +++++++ +++ + + +
++ +   +       + +       +   + + +       + + + +   +
++ + + +++++++ + + +++++++++ + + +++++++ + + + +++++
++ + +       + + +     +   + + + +   +   +   +     +
++++ +++++++ +++ + +++ + + + +++ + + + +++++++++++ +
++   +   +   +   + + +   + +   + + + +             +
++ +++ + + +++ +++ + +++++ +++ + +++ +++++++++++++ +
++  s+ +   +   +   +   + +   +   +           +   + +
++++++ +++++ +++++ + + + + +++++++ +++++++++ + +++ +
++   + +   +     +   + + +       +     +     + +   +
++++ + + + + +++ +++++ + +++++++ + +++ +++++ + + +++
++   + + +   + +   + + +       +   + +     + + +   +
++ + + +++ +++ +++ + + +++++ + +++++ +++++ + + +++ +
++ + +   +     +   +   +   + +   +   +   + +     + +
++ + +++ + +++++ +++ +++ + +++++ + + + + + +++++++ +
++ + +   + +     +   +   +     + + +   + +       + +
++ +++ +++ + +++++++ +++ +++++ + +e+++++ +++++++ + +
++   + + + + +     +     +   + + +   + +   +   +   +
++++ + + + + + +++ +++++++ +++ + +++ + +++ + + +++++
++   + +   +   + +   +   +     + +   +   + + +     +
++ + + + +++++++ +++ + +++ +++++ + +++++ + + + +++++
++ + + + +         + + +   +             +   +     +
++ +++ + + +++++++++ + + +++ +++++++ +++++++++++++ +
++     + + +   +     + + +   +     + +   +       + +
++ +++++ + + + + +++++ + +++++ +++ +++ + + +++++ + +
++     +   + +   +     + +     +   +   + + +   +   +
++++++ +++++ +++++ +++ + + +++++ +++ +++ + + +++++ +
++           +       +     +         +     +       +
++++++++++++++++++++++++++++++++++++++++++++++++++++
++++++++++++++++++++++++++++++++++++++++++++++++++++