++++++++++++++++++++++++++++++++++++++++++++++++++++
++ +   +                     +           +     +   +
++ + + + +++++++++ + +++++++ + +++++++ +++ +++ + + +
++   +     +     + +   + +   +       + +   +s+   + +
++ +++++++++ +++ +++++ + + +++ +++++++ + +++ +++++ +
++ +   +     + + +     + + +   +       +     +   + +
++ + +++ +++++ + + +++++ + +++++ + +++++++++++ +++ +
++ + +   +     + +     + + +     + +       +       +
++ + + +++ + + + +++ + + + + +++++++ + +++++ +++++++
++ + + +   + + +   + + + + + +     + +     +       +
++ + + + +++ + +++ + + + + + + +++ + +++++ +++++++ +
++   + +   + + +   + + + + + + +   + +   +         +
++++++ +++ + +++ +++++ + + + + + + + + + +++++++++++
++     +   +     +     + + +   + + + + + +         +
++ +++++++ +++++++ +++++ + +++++ +++ + + + +++++++ +
++       +     +   +     + +   +   + + +         + +
++ +++++ +++++ + +++ +++++ + + +++ + + +++++++++++ +
++   + + +   + + +     +   + +     + + +   +     + +
++++ + + + + + + +++++ + +++ + +++++ + + + + +++ + +
++ +   +   + +   +   +       + +     +   + + +     +
++ +++ +++++ +++++ + +++++++ +++ +++++++++++ +++++ +
++ +   +   +   +   +   +   + +   +         +     + +
++ + +++ + +++ + +++++ + + +++ +++++ +++++ + +++ + +
++ +     +   + + +   + + + +   +     +   + +   + + +
++ +++++++++ + + + +++ + + + +++++ +++ + + +++++ + +
++   +     + +   + +  e+ + + +   +   + + + +     + +
++ +++ + +++ +++++ + +++ + + + + + + + + + + +++++ +
++   + + +   +     +   + +   + + + + + + + + +     +
++ + + + + +++ +++ +++ + +++++ + +++ + + + + + +++++
++ +   +       +     +         +     + +     +     +
++++++++++++++++++++++++++++++++++++++++++++++++++++
++++++++++++++++++++++++++++++++++++++++++++++++++++