++++++++++++++++++++++++++++++++++++++++++++++++++++
++++++++++++++++++++++++++++++++++++++++++++++++++++
++       + +           +                 +     +   +
++++ +++ + + +++ +++++++ +++++ + +++++++ +++ + + + +
++   +     + + +             + + +     +   + +   + +
++ +++++ +++ + +++++++++++++++ + + +++ +++ +++++ + +
++     + +   +     + +       + + +   + + +     + + +
++ +++ + + +++ +++ + + +++++ + +++ +++ + +++++ +++ +
++ + + + + +   +   + + +     + +   +   +     + +   +
++ + + + + +++ + +++ + +++ +++ + +++ +++++++ + + + +
++   + + +     +     +   +     +   + +     + +   + +
++++ + + +++++++++++ +++ + +++++ +++ + +++ + +++++ +
++ + + +   +       +   + + +   + +   + + + +       +
++ + + +++ +++++ +++++ + +++ + + + +++ + + +++ +++++
++   + +         +     + +   + + +     + +   +     +
++++++ + +++++++++ +++++ + +++ + +++++++ +++ +++++ +
++     +   +     +   + +   +   +   +       +     + +
++ +++++++ + +++ +++ + +++++ +++++ + +++++ +++++ + +
++ +     + +   +   +       + +   + + +       +   + +
++ + +++ +++++ + +++++ +++++ + + + + + +++++++ +++++
++ +   +     + +       +     + +   + + + +   +     +
++ +++ +++ + + +++++++++ + +++ +++++ + + + + +++ + +
++   +   + + +   +     + + +   +     +   + +   + + +
++ + +++ + +++++ + +++ + +++ +++++ +++++++ +++ +++ +
++ + +   +   +   +   + +     +     +     + +   +   +
++ + + +++++ + +++++++ +++++++ + +++ +++ + +++ + + +
++ + +   + +   +     +       + + +   +   +   +   + +
++ +++++ + +++++++ + + +++++ + + + +++ +++++ +++++ +
++ +   +   +       + + + +   + + + +   +     + +   +
++ + + +++ ++e++ +++ + + + +++ + + + +++++ +++ + +++
++   +           +     +       + +s+       +       +
++++++++++++++++++++++++++++++++++++++++++++++++++++