++++++++++++++++++++++++++++++++++++++++++++++++++++
++++++++++++++++++++++++++++++++++++++++++++++++++++
++       +     +s+         + +     +     +         +
++ + +++ +++ +++ + +++++ + + + + +++ + +++ + +++++ +
++ +   + +   +   + + +   + +   + +   +   + + +   + +
++ +++ + + + + +++ + + +++ + +++ + +++++ + + + + +++
++ +   +   + + +     +   + + +   +     +   +   +   +
++ + +++++++ + +++++++++ + + + + +++ +++++ +++++++ +
++ +       + +   +       + + + +   + +   + +       +
++ ++e++++ + +++ + +++++++ + + +++++ + + +++ +++++ +
++ +   +   +   +   +       + +       + +     +   + +
++ +++ + + +++++++++ +++++++++++++++++ + +++++ + +++
++     + + +   +     +                 + +   + +   +
++++++ + +++ + + +++++ +++++++++++++++++++ + + +++ +
++   + +     +   +   +               +     +   +   +
++++ + +++++++++++ + +++++++++++++++ + +++++++++ + +
++   + +         + +         +     + + +   +   + + +
++ +++ +++ +++++ + + +++++++ + +++ + + + +++ + + + +
++   +     +     + + +   +   +   + +     +   +   + +
++ + +++++++ +++++ +++ + + +++++ + +++++++ +++++++ +
++ + +     + +   +     + +     + +     +   +   +   +
++ + + + + + +++ + +++++ +++++ + +++++ + +++ + + +++
++ + + + + +   +   +     +   +   +   +   +   +   + +
++ + + + + +++ + +++ +++++ +++++++ + +++++ +++++++ +
++ +   + + +   + +   +   +       + +   + + +       +
++++++++ + + +++++ +++ + + +++ + + +++ + + + +++++ +
++       + +     + +   + + + + +   +     +   +   + +
++ +++++++++++++ + +++ + + + + +++ +++++++++++ +++ +
++ +     +       +   + + +   +   + +   +           +
++ + +++ + +++++++++ + +++++ +++ +++ + + +++++++++++
++     +             +         +     +             +
++++++++++++++++++++++++++++++++++++++++++++++++++++