++++++++++++++++++++++++++++++++++++++++++++++++++++
+     +     +       +   +         +     +   +     ++
+++ +++ + +++ + +++ + + + +++++ +++ + +++ + + +++ ++
+   +   +     + +   + + + +   +     +     +   + + ++
+ + + +++++++++ + +++ + + + + +++ +++++ +++++++ + ++
+ + +         + + +   +   + +   + +   + +   +   + ++
+ +++++++++++ + +++ +++++++ +++ +++ + + + + +++ + ++
+ +           +           +   +     + +   +     + ++
+ + +++++++++++++++++++++ +++ +++++++ +++++++++++ ++
+ +     +   +       +   +   + +   +   +     +     ++
+ +++++ + + +++++ + + + +++ + + + + +++ +++ + +++ ++
+ +       +     + + + +   + + + + +     + +   +   ++
+ + +++++++++++ +++ + +++ +++ +++ +++++++ +++++ ++++
+   +   +   +   +   +   + +   +     +         +   ++
+ +++ + + + + +++ +++++ + + +++ +++++ + +++++++++ ++
+ +   +   + +     +     + +   +       + +     +   ++
+++ +++++++ +++++++ +++++ + + +++++++++ + +++ + ++++
+   +     +s+   +   +     + + +     +   +   + + + ++
+ +++ +++ +++ + + +++ +++++ + + +++ + +++++ + + + ++
+ + + +     + + + +       + + +   +   +   + +   + ++
+ + + + +++ + + + +++++++ +++ + + +++++ + + +++++ ++
+ +   + + +   + + +     +   + + + +     + + +     ++
+ +++ + + +++++ + + +++ +++ + + + + +++++ + +++ + ++
+   + + +     + + +   + + +   + + +   + + +   + + ++
+++ + + +++++ + + + +++ + +++++++ +++ + + +++ +++ ++
+   + +     + + +   +   +           + + + +   +   ++
+ +++++++++ + + +++++ +++++ +++++++++ + + + +++ + ++
+ +     +   + +       +     +   +     + + +   + + ++
+ + +++ + +++ +++++e+++ + +++ + + +++++ + +++ + + ++
+   +     +             +     +         +       + ++
++++++++++++++++++++++++++++++++++++++++++++++++++++
++++++++++++++++++++++++++++++++++++++++++++++++++++