++++++++++++++++++++++++++++++++++++++++++++++++++++
++ +         +         +       +   +           +   +
++ + +++++ +++ +++++ + +++ +++ + + + +++ +++++ + + +
++ +   + +     +     +     +   + +     + +   + + + +
++ +++ + +++++++ +++++++++++ +++++++++ + + + +++ + +
++             + +   +   + + +       + +   +     + +
++ +++++++++ +++ + + + + + + +++ +++ + +++++++++++ +
++ +       + +   + +   +   +   + + + +   +   +   + +
++ + +++++ +++ +++ +++ +++++++ + + + +++ + + + + + +
++ + + +   +   +   + + +       + +   +     + + + + +
++++ + + +++ +++ +++ + + +++++++ +++ +++++++ + + + +
++   + + +   +   +     + + +       +     +     + + +
++ +++ + +++ + +++++++++ + + +++++ +++++ +++++ +++ +
++ +s+ +   + +           + + +   +   + +     + +   +
++ + + +++ + +++++ +++++++ + +++ +++ + +++++ +++ + +
++   +     +     +       + + +   +   +     + +   + +
++++++ +++++++++ +++++++ + + + +++ +++ + +++ + +++ +
++   + +       +   +   + + + +   +   + +   +   + + +
++ +++ +++++ + +++ + +++ + + + + +++ +++++ +++++ + +
++   +       + +   + +   +   + +   +     + +       +
++++ +++++++++ + +++ + +++ +++++ +++++++ + + +++++++
++   +     +   +   + + +   +   +     +   + + +     +
++ +++ +++ + +++++ + + + +++ + +++ +++ +++ + + +++ +
++ +   + + + +     +   +     +   + +   +   +   + + +
++ + +++ + + + +++++ +++++ +++++ + + +++++ +++++ + +
++   +   +   +   + +   +   +   +   + +   + +       +
++ +++++ +++++++ + +++ +++++ + +++++ + + + + +++++++
++ +   +       + + +   +   + +     +   + + +   +   +
++ + + + +++++ + + + +++ + + +++++ +++++ + +++ +++ +
++   +   +       +       +   +           +         +
++++++++++++++++++++++++++++++++e+++++++++++++++++++
++++++++++++++++++++++++++++++++++++++++++++++++++++