++++++++++++++++++++++++++++++++++++++++++++++++++++
+++++++e++++++++++++++++++++++++++++++++++++++++++++
+                   +         +         +         ++
+ +++++++++ +++++++ + +++++++ +++++ +++++ +++++++ ++
+ +         +     + +   +           +   +   + +   ++
+ + +++++++++ +++ + +++ + +++++++ +++ + +++ + + + ++
+ + +         + +   +   + +     + +   +   + + + + ++
+ + + +++++++++ +++++ +++++ +++ +++ +++ +++ + + + ++
+ + + +   +     +         + + +     + +     + + + ++
+ + + + + + +++ + +++++++ + + +++++++ +++++++ + + ++
+ + + + +   +   + +       +     +   +     +   + + ++
+ + + + +++++ +++ + +++++++++++ + + +++ + + + + ++++
+ + +   + +   +   + +       +   + +     +   + +   ++
+++ +++++ + +++++++ + +++++ + +++ +++ +++++++++++ ++
+   +   +   +     +   +     + +   +   +         + ++
+ +++ + + +++ +++ + +++ +++++ + +++ +++ +++++++ + ++
+     + +     + + +   +   +     +   + +   +   + + ++
+++++++ +++++++ + + +++++ + +++++++ + +++ +++ + + ++
+       +       + + +   +   +     + +   +   + + + ++
+ +++++++ +++++ + +++ + +++++ +++ + +++ +++ + + + ++
+   +     +   + + +   +       +   +       + +     ++
+ + +++ + + + +++ + +++ +++++++ +++ +++++++ +++++ ++
+ +   + +   +     +   + +     +   + +     +   +   ++
+++++ + +++++++++++++ +++ +++ +++ +++ +++ + + + ++++
+   + + +     +     +     +   +       + + + + +   ++
+ + + + +++ + +++ + + +++++ +++++++++++ + +++ +++ ++
+ +   + +   +     + +     +       +     +   +   + ++
+ +++++ + +++++++++ +++ +++++++++ + +++ +++ + + + ++
+ +   +   +   +     +   +         + + +   + + + + ++
+ + + +++++ + + +++++++++ +++++++++ + +++ + +++ + ++
+   +s+     +             +             +       + ++
++++++++++++++++++++++++++++++++++++++++++++++++++++