++++++++++++++++++++++++++++++++++++++++++++++++++++
+   +         +                     +       +     ++
+ +++ + +++++ +++ +++++++++++ +++++++ +++++ + +++ ++
+     +   + +     +   +     + +       +   + +   + ++
+ +++++++ + +++++++ + + +++++ + +++++++++ + + +++ ++
+       + + +       +   +   + + +         +   +s+ ++
+++++ +++ + + +++ +++++ + + + + +++++ +++ +++++ + ++
+     +   +     + +   + + +   +   +   +     + + + ++
+ +++++ +++++++++ + + + + +++++++ + + +++++ + + + ++
+     +     +     + +   + +     +   + +   +   + + ++
+++++ +++++ + +++++ +++++ + +++++++++ + + +++ + + ++
+ +   +     +     + +     +   +       + +   + + + ++
+ + +++ +++++++++ +++ +++++++ + +++++++ +++ +++ + ++
+ +   + +         +   +     + + + +     + +     + ++
+ +++ + + +++ +++++ +++++ + + + + + +++++ +++++++ ++
+ +   + +   + +   + +   + + + + + + +       +     ++
+ + +++ + + +++ + + + + + + + + + + +++ +++ + ++++++
+ +   + + +   + +     +   +   + + +     + +   +   ++
+ +++ + +++ + + +++++++++++++++ + +++++++ +++++ + ++
+   + +   + +   +   +     +   +   +       +     + ++
+ +++ +++ +++++++ + + +++ + + +++ + +++++ +++++ ++++
+ +     +   +   + +     +   +   + + +   +     +   ++
+ + +++++++ + + + +++++++++e+++ + + + +++++++ +++ ++
+   +       + +   + +           +   +       + +   ++
+ +++ + +++++ +++++ + +++ +++++ +++++++++++ + + + ++
+ + + + +   +       +   + +   +             +   + ++
+ + + +++ + +++++++ +++ + + + +++++++++ +++++++++ ++
+   +     + +     +   + + + +   +     + +   +     ++
+++ +++++++ + +++ +++ + +++ +++ + +++ +++ + + ++++++
+         +     +     +       +     +     +       ++
++++++++++++++++++++++++++++++++++++++++++++++++++++
++++++++++++++++++++++++++++++++++++++++++++++++++++