++++++++++++++++++++++++++++++++++++++++++++++++++++
++ +         +   +                   +   +         +
++ + +++++ +++ + + +++ +++++++++++++++ + + +++ +++ +
++ +   + +     + + + +     +     +     + + +s+ +   +
++ +++ + +++++++ + + +++++ + +++ + +++++ + + +++ + +
++   +     +   + +   +   +     + +   + +   + +   + +
++ + +++ +++ + + +++ +++ +++++++ +++ + +++++ + +++ +
++ +     +e  +     +   +     +   + + +   +   +   + +
++ +++++++ +++++++ +++ + + +++ + + + + +++ +++++ + +
++       + +     + +   + + +   +   + + +   +     + +
++++++++ + + +++ +++ +++ +++ + +++++ + + +++ +++++ +
++   + + + +   +   + +   +   + +       + +   + +   +
++ + + + + +++ +++ + + +++ + +++ +++++++ + +++ + +++
++ +   + +       +     +   + +   + +     +   + + + +
++ +++++ +++++++++++++++ +++ + +++ + +++++ + + + + +
++     +   + +     +     +   + +   +   +   + + + + +
++ +++ +++ + + +++ + + +++++++ +++ +++ +++++ + + + +
++   +   +   + +   + + +     + +   +   +     +   + +
++++ +++ +++ + + +++ +++ +++ + + + + +++ +++++ +++ +
++ + +     + + +     +   + +     + + +     +       +
++ + + +++++ + +++++++ +++ +++++++ + +++ + +++++++++
++   +   +   +       + +     +   + +   + +         +
++++++++ + +++++++++ + + +++++ + +++++ +++++++++++ +
++       + +     +   +   +     +   +   +           +
++ +++++ + + +++ + +++++ + +++++++ + +++ +++++++++ +
++ +     +   +   + +     + +     +   +   +       + +
++ +++++ +++ +++++ + +++++ +++ + +++++ + + +++++++ +
++     + +   +     + + +   +   +   +   + +         +
++ +++ +++ +++ +++++ + + +++ +++++ +++++ + +++++++++
++   +       +         +     +           +         +
++++++++++++++++++++++++++++++++++++++++++++++++++++
++++++++++++++++++++++++++++++++++++++++++++++++++++