++++++++++++++++++++++++++++++++++++++++++++++++++++
++++++++++++++++++++++++++++++++++++++++++++++++++++
+   +             +           +     e +     +   + ++
+ + +++++++++ +++ + + +++++++ +++ +++ + +++ + + + ++
+ +   +   +s+   +   +     + +     + +   + +   +   ++
+ +++ + + + +++ +++++++ + + +++++++ +++++ +++++++ ++
+ + +   + + +   +     + + + +   +             +   ++
+ + +++++ + +++++ +++ + + + + + + +++++++ +++ + ++++
+ + +     +   +   +   + + + + +   +     +   + + + ++
+ + + +++++++ + +++ +++++ + + +++++++++ +++ +++ + ++
+   +   +     +   + +   + + + +       +   + +   + ++
+++ +++ + +++++++ + + + + + + + + +++ + + + + +++ ++
+     + +     +   +   + + +   + + +     + + +   + ++
+ +++++ +++++ + +++++++ + +++ +++ +++++++++ +++ + ++
+ + +       + + +     + +   +   + +       +   + + ++
+ + + +++++ + + +++ + + +++ +++ + + +++++ + +++ + ++
+   +     + + +   + +       +     + +   +   +   + ++
+++ +++++ +++ +++ +++++++++++ +++++ + + +++++ +++ ++
+ +     +   +   +       +     +   +   +     +     ++
+ +++++ +++ +++ + +++++ +++++++ + +++ +++++ +++++ ++
+     + + +     +   + +   +   + +   +   + +       ++
+ +++++ + +++++++++ + +++ + + + +++ +++ + ++++++++++
+     + + +         +   +   + + +   +     +       ++
+ +++ + + + +++++++ +++ +++++ + + +++++++ +++++++ ++
+ + +   +     +   +         +   +     + +       + ++
+ + +++++ +++++ + + +++++++++++++++++ + +++++++ + ++
+ +     +   +   + + +               + + +     + + ++
+ + +++ +++++ +++ +++ +++++++++++++ + + + +++ + + ++
+   + +       + +     +           +   +   + + + + ++
+++++ +++++++++ +++++++ +++++++ +++++++ +++ + + + ++
+                             +             +     ++
++++++++++++++++++++++++++++++++++++++++++++++++++++