++++++++++++++++++++++++++++++++++++++++++++++++++++
++           +         +       +         +         +
++ +++++++ + + +++++++++ +++++ + +++++ +++ + +++++ +
++ +   + + +   +     +   +   + +     + +   + +     +
++ + + + + +++++ +++ + +++++ + +++++ + + +++ + +++++
++   + + +     +   +   +     +   +   + + +   +     +
++++++ + +++++ +++ +++++ +++ +++ + +++ + + +++++++ +
++   +   +       +   +   +     + +   +   + +     + +
++ + +++ + +++++ +++ +++ +++++ + + +++++++ + +++ + +
++ +   + + +   +   + +   +   + +   +       +   + + +
++ +++ + + + + +++ + + +++ + +++++++ +++++ +++ + +++
++   +   + + +     + +     + +       + +   + + +   +
++ +++++++ +++++++ + + +++++ + +++++++ + +++ + +++ +
++ +       +     + + + +     + +             +   +s+
++ + +++++++ +++ + + +++ +++ + +++++++++++++ +++ +++
++ +   +   +   + + +   + +   + +   +       + + + + +
++ +++ + + +++ + + +++ + + ++e + + + +++++ + + + + +
++ + +   +   + + +   + + +   +   + +     + + + +   +
++ + +++++ +++ + +++ + + +++ +++++ +++ +++ + + +++ +
++ +     +     +   + + + +   +   +     +   +   +   +
++ + +++ +++++++++ +++ + +++ + +++++++++ +++++++ +++
++ + +   +     + +   + +   + +       + +         + +
++ + +++ +++ + + +++ + + + + +++ +++ + +++++++++++ +
++ +   + +   + +   +   + + +     + +   +           +
++ +++ + + +++ + +++++++++ +++++++ +++ +++++ +++++ +
++ +   +   +   +       +   +         + +     +   + +
++ + +++++++ +++++ +++ + +++ +++ +++++ + +++++ + + +
++ + +       +   + +   + +   + +     + + +   + + + +
++ + + +++++++ + + + +++ + +++ +++++ + + + +++ + + +
++   +         +   +     +         +     +     +   +
++++++++++++++++++++++++++++++++++++++++++++++++++++
++++++++++++++++++++++++++++++++++++++++++++++++++++