++++++++++++++++++++++++++++++++++++++++++++++++++++
++++++++++++++++++++++++++++++++++++++++++++++++++++
++       +   +       +             +               +
++++++ + + + + +++++ + +++++++++++ + +++++++++ +++ +
++     + + +   +     + +         +   +         + + +
++ +++++ + +++ +++++++ +++++ +++ +++++ +++++++++ + +
++ +   +   +   +     +   +   +   +   +   + +       +
++ + + +++++ +++ +++ +++ + +++ +++ +++++ + + +++++++
++   + +       + + +   +   +   +   +     +     +   +
++ +++ e++++++ + + + +++++++ +++++ + +++++++++++ + +
++ +   +   +   +   +   +   +     + + +           + +
++ + + + + +++++++ +++ + + +++++ + + + +++++++++++ +
++ + + + +           +   +     +   +   +   +     + +
++ + +++ +++++++++++++++++++ +++++ +++++ + + +++ + +
++ +     +       +       +   +           + + +     +
++ +++++++++++++ + +++++ + +++ +++++++++++++ +++++ +
++ +             +   + + + +   +     +     +   +   +
++ +++ +++++ +++++++ + + + + +++ +++ + +++ +++ +++++
++     +   + +       +   + + + +   +   + +   +     +
++++++++ +++ + +++++++ +++ + + +++ +++++ +++ + +++ +
++     +     +   + +   +   + +   + +       + +   + +
++ +++ + +++++++ + + +++ +++ + +++ + +++++ + +++++ +
++ +   +   +     + + +     + + +   + +   +         +
++ +++ +++++ +++++ + + +++ + + + +++ + + +++ +++++++
++   +   +   + +   + + +   +   +   + + +   + +     +
++ + +++ + +++ + + + +++ +++++ +++ +++ +++ +++ +++ +
++ + +     +     +       +   +   +     + + +s+   + +
++++ + +++++++++++++++ +++ + +++ +++++++ + + +++ + +
++   + +     +     +   +   +     +   +   + +     + +
++ +++++ +++ + +++ +++++ +++++++++ + +++ + +++++++ +
++         +     +                 +     +         +
++++++++++++++++++++++++++++++++++++++++++++++++++++