++++++++++++++++++++++++++++++++++++++++++++++++++++
++++++++++++++++++++++++++++++++++++++++++++++++++++
++           +             +       + +           + +
++ +++++++ + +++++++ + +++ +++++ + + + + +++++++ + +
++ +       +       + + + +   +   + + + +   +   +   +
++ + +++++++++++++ +++ + +++ + +++ + + +++ + + +++ +
++ + +       +     +   +   +   + + + +   +   + +   +
++ + +++ + +++ +++++ +++ + +++++ + + +++ +++++ + +++
++ + +   + +         +   +       + +     +   + +   +
++ + + +++ + +++++++++ +++ +++++ + + +++++ + + +++ +
++ + + +   + +     +   +   +   + + + +     +   +   +
++++ + +++++ + +++ +++ + +++ + +++ +++ + +++++++++ +
++   +       + + +   + +     +     +   + +   +   + +
++ +++ +++++++ + +++ +++++++++++++ + +++++ + + + +++
++ +         + +   +   +         +   +   + + + +   +
++ +++++++++ + +++ +++ + +++++++ +++++ + + + + +++ +
++ +       + +     + + +   +   + +     +   +   + + +
++ + +++++ +++++++ + + +++ + + + + +++++++++++++ + +
++     +   +     +   +     + +   +    s+       + + +
++++++++ +++ + + +++ +++++++ +++++++++++ +++ + + + +
++     + +   + +   + +     +         +   + + +   + +
++ +++ + + +++ +++ + + +++++++++++ + + +++ + +++++ +
++   + + +   + +   + +           + + + +   + +   + +
++ + + + + +++ +++++ + +++++ +++ + + + + +++ + + + +
++ + + +   +   +     +   + +   + + + + +   + + +   +
++ + + +++++ +++ +++++++ + +++ +++ + + +++ + + +++++
++ + + +     +   +     + +   + +   + +     +   +   +
++++ + + +++ + +++ +++ + +++ + +e+++++++++ +++++++ +
++   +   +   +   + + + +     + +     +     +       +
++ +++++++++++++ + + + +++++++ +++++ + +++++ +++++ +
++                 +               +         +     +
++++++++++++++++++++++++++++++++++++++++++++++++++++