++++++++++++++++++++++++++++++++++++++++++++++++++++
++++++++++++++++++++++++++++++++++++++++++++++++++++
++       +         +       +           +           +
++++++++ + +++ +++ + +++++ +++++ +++ +++ +++++ +++ +
++     +   +   +     +   +     + +   +       + +   +
++ +++ +++ + +++++++++ +++++++ + + +++ +++++++ + +++
++   +   + + +   +     +     + + + +   + +   + +   +
++++ +++ +++ + + + +++ + + +++ + +++ +++ + + + +++ +
++   + +   +   + + + +   + +   +       + + +   +   +
++ +++ +++ +++++ + + +++++ + +++++++++ + + +++++ +++
++ +             +   +     + +       +   +   +   + +
++ +++++++++++++++++++ +++++ +++ +++ +e+++++ + +++ +
++         +         +     + +   +         + +     +
++ +++++ + + +++++ + + +++ + + +++++++++++ + +++++ +
++ +   + + + +   + + +   + + +     + +     +   + + +
++++ + +++ + +++ + + +++++ + +++++ + + +++++++ + + +
++   +   + +   + + + +     +       + +   +     +   +
++ +++++ + +++ + + + + +++ +++++++++ +++ + +++++ +++
++     + +   +   + + + + + +     +     +   +   +   +
++ +++++ + + + +++ + + + + + +++ + +++++++++ +++++ +
++ +s    + + + +   +   +   +   +   +     +         +
++ +++++++++ + + +++++++ +++++ + +++ + +++ +++++++++
++     +   + + +   +     +     + +   +     +       +
++++++ + + + + +++ + +++++++ +++ + +++++++++++++++ +
++   +   +   + + + +   +   +   + +         +       +
++++ +++++++++ + + +++ + + +++ + +++++++++ + +++++ +
++   +       +   + +     +     + +     +   + +   + +
++ +++ +++++ +++ + +++++++++++++ + +++ + +++ + +++ +
++ +   +   +   + +         +     + + + + +   +     +
++ + +++ + +++ + +++++++++ +++++++ + + + + +++ +++++
++       +   +           +           +     +       +
++++++++++++++++++++++++++++++++++++++++++++++++++++