++++++++++++++++++++++++++++++++++++++++++++++++++++
++++++++++++++++++++++++++++++++++++++++++++++++++++
++     +       +       +             +       +     +
++ + + +++ + +++ + +++++ +++++++++ + + +++++ + +++ +
++ + +   + +     +     +       +   + + +   + + + + +
++ + +++ + +++++++++++ +++ +++++ +++ + +++ + + + + +
++ +   + + +         +   + +     +   +     +   + + +
++ +++ + +++ +++++++ + + + + +++++ +++++++ +++++ + +
++ + + +     +   +   + + + + +   +       +       + +
++ + + +++++++ +++ +++++ + + + + +++++++ +++ +++++ +
++ + + +       +   +   + + +   + + +   +   + +     +
++ + + +++++ + + +++ + + + +++++ e + + +++ +++ +++ +
++   +   +   + + +   +   + +     +   +   +   + +   +
++ +++++ + +++++ +++ + +++ + +++++++ +++ +++ + + +++
++ +     +           + +   + +     + +     +   + + +
++ + + +++++++++++++++ + +++ +++ + +++ +++++++++ + +
++ + + +           +   + + +   + +     +       +   +
++++ +++ +++++++++ +++++ + +++ + +++++++ +++ + +++ +
++   +   +       +         +   +     +   +   +   + +
++ +++ +++++ + +++++++++++ + +++ +++ + +++ +++++ + +
++ +   +     + +       +   +   +   + +   +     + + +
++ + +++ +++++ + +++++ +++++++ +++++ +++ +++++ +++ +
++   +   +     +     +         +   +   +   +   +   +
++ +++ +++ +++++++++ +++ +++++++ + + +++++ + +++ +++
++ +   +   +       + +   +   +   + +     + +     + +
++ + +++ +++ +++++ + +++++ + + +++ + + + + +++++++ +
++ +   +   +   +   +       + + +   + + + + +       +
++ +++ +++ +++++ + +++++++++ + + +++ + +++ + +++++ +
++     +   +   + + +   +   + + + +s+ +   + + +   + +
++++++++ +++ + + + + + + + + + + + + +++ + +++ + + +
++           +   +   +   + +   +   +   +       +   +
++++++++++++++++++++++++++++++++++++++++++++++++++++