++++++++++++++++++++++++++++++++++++++++++++++++++++
++                   +           +       +         +
++ +++++ +++++++++++ + +++++++++ +++++ + + +++++ + +
++     + +         +   + +     + +   + +   +     + +
++ +++ +++ +++++++ +++++ + +++ + + + +++++++ +++++ +
++   +         +   +     + +   +   + +   +   +   + +
++++++++++++++ + +++++ +++ + + +++++ + + + +++ + + +
++       +     + +   +   + + +   +   + +   + + + + +
++ +++++ +++++++ + + + + + + +++++ +++ +++++ + + + +
++ +   +       +   + + +   +   +   +   +       +   +
++ + + +++++++ + +++ +++++++++ + +++++ + +++++++++++
++ + +   +     + + +         + +       +     +     +
++ + + + + +++++ + +++++++++ + +++++++++++++ + +++ +
++ + + + + + +   +     + +   + +     +     + +   + +
++ +++ + + + + +++ +++ + + +++ + +++ + +++ + + +++ +
++     + + +       + + + +   +     +     +   + +   +
++++++++ + +++++++++ + + +++ ++e++ +++++++++++ + +++
++ +     +       +   +   + +     + +           +   +
++ + +++++++++++ + + +++ + +++++ +++ +++++++++ +++ +
++ +   +       + + +     +     + +   +       +   + +
++ +++ + +++++ + +++++++ +++++ + + +++ +++++ +++++ +
++   + +     + +   +   +       + +   + +   + +   + +
++ +++ + +++ + +++ + + + +++++ + +++ + + +++ + + + +
++     + +   + +   + +s+ +   + +     + +     + +   +
++ +++++++ +++++ + + +++++ + + +++++++ + +++++ +++ +
++   +   + +     + + +     + +       + +   +   +   +
++++ + + + + +++++++ + +++++ +++++++++ +++ + +++ +++
++ + + + + +         +     + +       + + +   +   + +
++ + + + + +++++++++++++++ + + +++++ + + +++++ +++ +
++     +                   +   +       +           +
++++++++++++++++++++++++++++++++++++++++++++++++++++
++++++++++++++++++++++++++++++++++++++++++++++++++++