++++++++++++++++++++++++++++++++++++++++++++++++++++
+           +     +       +   +       +           ++
+ +++ +++++++ + +++ +++ + +++ + +++++ + + +++++++ ++
+   + +       +     + + +     +   +   + +     + + ++
+++ + + +++++++++++++ + +++++ +++ + +++ +++++ + + ++
+   + + +   +         +   + + +   +     +     + + ++
+ +++++ + + + +++++ +++++ + + + +++++++++ +++++ + ++
+ +   + + + + + +   +     +   +     +     +       ++
+ + + + + +++ + + +++ + +++++++ +++++ +++ +++++++ ++
+ + + + +   +   +   + + +   +   +     +   +     + ++
+ + + + +++ +++ +++ + +++ + + +++ + +++++++ +++ ++++
+   + +   +     +   +   + + +   + + +       + +   ++
+++++ +++ +++ +++ + +++ + + +++ + +++ +++++++ +++ ++
+     + +   +   + + + + + +     +   + +       +s  ++
+ +++ + +++ + +++ + + + + +++++++++ + + +++ ++++++++
+   +   + + + +   +   + +     +   +   +   +     + ++
+++ +++ + + +++ +++++ + +++++ + + +++++++++++ + + ++
+   + + + + +   +     +     + + +             + + ++
+ +++ + + + + +++++++ +++++ + + + +++++++++++++ + ++
+ +   + + + +       + +   +   + +   +     +   + + ++
+ + +++ + + + +++++ + + + +++++++++ +++ + +++ + + ++
+ +   +   + + + +   +   + +         +   +   + + + ++
+ + + +++ + + + + +++++++ +++ +++++++ +++++ + + + ++
+ + + +   + +   + +   +   +   +   +e  +   + + + + ++
+ + + + +++ +++++ + +++ +++ +++ + + + +++ + + + + ++
+ + +     + +     +   +     +   +   +   +     + + ++
+ +++++++++ + +++++ + +++++++ +++++++++ +++++++ + ++
+ +       + + +   + + +     +   +     +       +   ++
+ + +++++ + + + +++ + + + +++++ +++++ +++++++ +++ ++
+       +     +     +   +                   +     ++
++++++++++++++++++++++++++++++++++++++++++++++++++++
++++++++++++++++++++++++++++++++++++++++++++++++++++