++++++++++++++++++++++++++++++++++++++++++++++++++++
++ +    s+         +       +     +e      +         +
++ + +++++ +++ +++ + +++++ + +++ + +++ +++ +++++++ +
++ + +   + +   + + + +     +   +   + +   +       + +
++ + + +++ + +++ + + + +++++++ +++++ +++ +++++++ + +
++   +     + +   + + +       +     + +     +     + +
++ +++++++ + + + + + +++++ +++++++ + + + +++ +++++ +
++ +     + + + +   +     +         + + + +       + +
++ + +++ +++ + +++++++++ +++++ +++++ + +++ +++++++ +
++ + + +   + + +     +   +   + + +   +     +       +
++ + + +++ + + + +++ + +++ + + + + + +++++++ +++++ +
++   +   +   +   +   +   + + + +   +   +     +     +
++++++ +++++++++++ +++++ + + + +++++ +++ +++++ +++++
++     +     +   +   +   + + +     + +   +   + +   +
++++++ + +++ + + +++ + +++ + +++++ + + +++ +++ + +++
++     +   +   +   + + +   + +       + +   +   +   +
++ +++++++ +++++ + + +++ +++ +++++++++ + + + +++++ +
++     +   +   + + +     + +   +       + + +       +
++ +++ + +++ + + + +++++++ +++ + +++++++++ +++++++ +
++ + +   +   + + +     +     + +         +   + +   +
++ + +++++ +++++ +++++ +++++ + + +++++++ + + + + +++
++   + +       +     + +     + +     + + + +   +   +
++++ + + +++++ +++++ + + +++ + +++++ + + + +++ +++ +
++   +   +       + + +   + + +     +   + + +     + +
++ +++++++ +++++ + + +++++ + +++++ +++ + + +++++++ +
++       +   + +   +   +     +   +   + + + +   +   +
++++++++ +++ + +++ +++ +++++++ + +++ +++ + + + + +++
++       +   +   + +   +       +   + +   +   +   + +
++ +++++++ +++ + + + +++ +++++++++ + + +++ +++++++ +
++         +   +   +             +     +           +
++++++++++++++++++++++++++++++++++++++++++++++++++++
++++++++++++++++++++++++++++++++++++++++++++++++++++