++++++++++++++++++++++++++++++++++++++++++++++++++++
++++++++++++++++++++++++++++++++++++++++++++++++++++
++     +   +       +     +   +     +               +
++ +++++ + + +++ + +++ + + +++ + + +++ +++++ +++++ +
++       +     + +     + + +   + +   +     +     + +
++ +++++++++++++ + +++++ + + +++ +++ +++++ +++++ +++
++ + +           + +   +   +   +   + +     +   +   +
++ + + +++++++++++ + + + +++++ +++ + +++++++ + +++ +
++ + +     +     + + + + +     +   +       + +   + +
++ + +++++ + +++ +++ + +++ +++++ +++++++++ + +++ + +
++     + +     +     + +   + +   +       + e + + + +
++++++ + +++++++++ +++ + +++ + +++ +++++++++++ + + +
++ +     +     +s+   +   +   + +   +   +       +   +
++ + +++++ +++ + +++ +++++ + + + +++ + + +++++ +++ +
++ + +     + +   +     +   + + +     +   +   +     +
++ + + +++++ +++++++++ + + +++ + +++++ +++++ +++++++
++ + +       +       + + + +   + +   +             +
++ + +++++++ + + +++ + + + + +++++ + +++++++++++++ +
++   +       + +   + +   + + +     + +           + +
++ +++ +++++++ +++ + +++++ + + +++++ + +++ +++ +++ +
++ + + +     +   + + +   + +   +     +   +   + +   +
++ + + +++ +++++ + + +++ + +++++ +++++++ +++ +++ +++
++   +   +       + +   + +     + + +     + +     + +
++++ +++ + +++++++ +++ + +++++ + + + +++++ +++++++ +
++   +   + +   +   +   +       + + + +     +     + +
++ +++ +++ + + + +++++ +++++++ + + + + + + + +++ + +
++   + + + + + +     +   +   + + + + + + + + + + + +
++++++ + + + + +++++ +++ + + +++ + + +++ + + + + + +
++     +     + +     +   + +   + + +     + + +   + +
++ +++++++++++++ +++++ +++ +++ + + +++++++ + + +++ +
++               +         +     +           +     +
++++++++++++++++++++++++++++++++++++++++++++++++++++