++++++++++++++++++++++++++++++++++++++++++++++++++++
++++++++++++++++++++++++++++++++++++++++++++++++++++
++   +           +   +               +             +
++ + + + +++++++ + + +++++++ +++++++ +++++++++ + +++
++ + + +     +     +   +     +     + +       + +   +
++ +++ +++++ +++++++++ + +++++++ + + + +++++ + +++ +
++         +     +   +   +     + + +   +   + +   + +
++++++++++++ +++ + +++++++ +++ +e+ +++++ +++ +++++ +
++         + +s+ +         + +         +     +     +
++ +++++++ +++ + +++++ +++++ +++++++++ + +++++ +++++
++ +     +     +     + +   + +       + + +   +     +
++ +++ + +++++++++++ + + + + + +++++ + + +++ + +++ +
++   + +           + +   + +   +   +   +   + +   + +
++++ + +++++++++ + + + +++ + +++ + +++++++ + + +++ +
++ + + + +       +   +   + +   + +   +     +   +   +
++ + + + + +++++++++++++ + +++ +++++ + +++++ +++ + +
++   +   + + +         + + +         + + +   + + + +
++ +++++++ + + +++ + +++ + +++++ +++++ + + +++ + + +
++ +       +   +   + +   +   +   +     + + +   + + +
++ + + +++++ +++ +++++ +++++ + +++ +++++ + +++ + + +
++ + + +     + + +     +   + + + +   +   + +   + + +
++ +++ +++ +++ + + +++++ +++ + + +++ + + + + +++ + +
++   +   +     +     +   +   +     + + +   + +   + +
++++ + + +++ +++++++ +++ + +++++++++ +++ +++ + +++ +
++ + + +   + +   + +     +   +     +   +   + + +   +
++ + +++++ +++ + + +++ +++++ + +++ +++ +++ + + +++++
++ +     +     + +   + +     +   +     + +   + +   +
++ +++++ +++++++ + +++ + +++ +++ +++++++ +++ + + + +
++ +   + +       +   + +   + +   +           +   + +
++ + + + + +++++++ + + +++ +++ +++++++++++++++++++ +
++   +     +       +     +                         +
++++++++++++++++++++++++++++++++++++++++++++++++++++