++++++++++++++++++++++++++++++++++++++++++++++++++++
++++++++++++++++++++++++++++++++++++++++++++++++++++
+             +             +       + +   +   +   ++
+ +++ + +++++++ +++++++++ + + + +++ + + + + + + ++++
+   + + +   +   +       + + + + +     + + + + +   ++
+++ + + + + + +++ +++++ + +++ + +++++++ + + + +++ ++
+ + + + + + +     +     +   + + +       + + +   + ++
+ + + +++ + +++++++ +++++++ + + + +++++++ + +++ + ++
+   +     +   +     +     + + +   +   +   + +     ++
+ +++++++++ + + ++++++e++ + + +++++ + + +++ +++++ ++
+ +         + +       +   + + +     + + +     + + ++
+++ +++++++++ +++++++ + +++ + + + +++++ +++++ + + ++
+   +           + +   + +   + + + +   +   +   +   ++
+ +++ +++++++++ + + +++ + + + + + + + +++ + +++ ++++
+   + +     + +   + +   + + + + +   +   +s+ +     ++
+ + +++ +++ + +++ + +++ + + + +++++++++ +++ +++++ ++
+ +   + +   + +   +     + + +       +   +       + ++
+ +++ + + +++ + +++++++ + +++++++++ + + + +++++ ++++
+   +   +   + + +       + +         + + +     +   ++
+++ +++++++ + + + +++++++ + +++++++++ + +++++ +++ ++
+   +   +   +   + +     + +     +     +     + +   ++
+ +++++ + +++ +++ +++++ + +++++ +++ +++++++ + + ++++
+     + + +     + +   + +     +   +   + +   + +   ++
+++++ + + +++ +++ + + + +++ + +++ + + + + +++ +++ ++
+     + +   + +   + +   + + + +   + + +   +     + ++
+ +++++ +++ +++ +++ +++ + + + + +++ + + +++++++ + ++
+   +     + +   +     +   + + + +   + +     +   + ++
+++ + + +++ + +++++++ +++ + + + + +++ +++++ +++++ ++
+   + + +   + +     + +   + + + +   +   + + +     ++
+ +++ + + +++ +++ + + + +++ +++ +++++++ + + + +++ ++
+     + +         +   +   +             +     +   ++
++++++++++++++++++++++++++++++++++++++++++++++++++++