++++++++++++++++++++++++++++++++++++++++++++++++++++
+         +   +   +         +       +   +         ++
+++++ +++ + + + + + +++ +++++ +++ +++ + + + +++++ ++
+     +   + +   + +   + +       +   + +   + + +   ++
+ +++++ +++ +++++ +++ + + +++++++++ + +++++ + + ++++
+   +       +   +   + +   + +       +   + + + + + ++
+ + + +++++++ + +++ + +++++ + +++++ +++ + + + + + ++
+ + +  e+   + +     +     + + +   + + + + + +   + ++
+++ +++++ + +++++++ +++++ + + + + + + + + + +++ + ++
+   +     +   +   +   +   + + + +     +   +   +   ++
+ + + +++++++ + + +++ + +++ + +++++++++ +++++ ++++++
+ + + +     +   + +   + +   +         + +s  +     ++
+ +++ + +++ +++++ +++++ + + +++++++++ + +++ +++++ ++
+     +   + + +   +     + +       + + +   +     + ++
+ +++++++ + + + +++ +++++ +++++++ + + +++ +++++ + ++
+       + + + +   + +   + +     + + +   +   + +   ++
+++++++ + + + +++ + + + + + +++++ + + + +++ + ++++++
+ +   +   + +   + + + + + +       + + +   + +     ++
+ + + +++++ + +++ + + + + + +++++++ + +++ + +++ ++++
+   +     +   +   + + +   +         +   + +   +   ++
+ +++++++ +++ + +++ + +++++ +++++++ +++ + +++ + + ++
+ +     +     +       +   + +     + +   + +   + + ++
+ +++ +++++++++++++++++ + +++ +++ +++ +++++ +++++ ++
+   +             +     +   + +       +   +     + ++
+++ +++ +++ +++++ + +++++++ + +++++++++ + +++++ + ++
+ +   +   + +   + +   +       +   +     +     +   ++
+ +++ +++++ + + + +++ +++++++++ + + +++++ +++ +++ ++
+ +   +     + + +   +         + + +   +   +   +   ++
+ + +++ +++++ +++++ +++++++++ + + +++ + +++++++ ++++
+       +                   +   +     +           ++
++++++++++++++++++++++++++++++++++++++++++++++++++++
++++++++++++++++++++++++++++++++++++++++++++++++++++