++++++++++++++++++++++++++++++++++++++++++++++++++++
++++++++++++++++++++++++++++++++++++++++++++++++++++
++             +                 +           +     +
++ +++ +++++++ + +++ + +++++++++ + +++++++ + +++++ +
++ +   +   +   + +   + +s  +   + + +     + +     + +
++++ +++ +++ +++++ +++++++ + + + + + +++ + +++++ + +
++   +             +       + +   + + +     +       +
++ +++ +++++++++++++ +++++++ +++++ + +++++++++++++++
++ +     +     e     +     +     + +               +
++ +++++ + +++++++++++++ + +++++ + +++++++++++++++ +
++     + +         +     +   +   +         +   +   +
++++++ + +++++++++ +++ +++++ + +++++++++++ + +++ + +
++     + +       +   + +     +       +   +   +   + +
++ +++++ + +++++ +++ + + +++++++++++ + + +++ + +++++
++     + + +     +   + + +         + + + +   +     +
++++++ + +++ +++++ +++ +++ +++ +++ + + + + +++++++ +
++     +     +     +   +   + +   + + + +   +       +
++ +++++++++++ +++++ +++ +++ +++ +++ +++++++ +++++ +
++           + +       +   +   +     +   +   +   + +
++++++ +++++ + + +++++ +++ + + +++++++ + + +++ + + +
++   +   +   + + +   +   + + +         + + +   + + +
++ + +++++ +++ + +++ + + + +++ + +++++++ + + +++ + +
++ +     +   + +     + + +   + +     +   +     + + +
++ +++++ +++ + +++++ + +++++ +++ +++ +++ +++++ + + +
++     +     + +     +     +   + + +   + +   + + + +
++ +++ +++++ + +++++++++++ +++ + + +++ + + + +++ +++
++ + +   +   +     +       +   +     + +   +   +   +
++ + +++ +++++++++ + +++++ + +++++++++ +++++++ +++ +
++   + +       +   + +   + + +   +     +   +   +   +
++++ + +++++ +++ +++ + + +++ + + + +++++ + + +++ + +
++         +     +     +       +   +     +       + +
++++++++++++++++++++++++++++++++++++++++++++++++++++