++++++++++++++++++++++++++++++++++++++++++++++++++++
+   +         +               +               +   ++
+ + + +++++++ + +++++ +++++++++ +++++++++++ + +++ ++
+ + + +       +     +               + +     +     ++
+ +++ + +++++++++++ +++++++++++++++ + + ++++++++++++
+ +   +         +   +     +       +   + +     +   ++
+ + +++++++++ + + +++ +++ + +++++ +++++ + +++ + + ++
+ +   +   +   + +   + +     +     +     +   + + + ++
+ +++ + + + +++ +++ + +++++++++ +++ +++++++ + + + ++
+       + + +     + +         +     +       +   + ++
+++++++ +++ +++++++ +++++++++ +++++++ +++++++++++ ++
+   +   +   +   +   +     +   +       +   +   +   ++
+ + + +++ +++ + + +++++++ + +++ +++++++ + + + + ++++
+ + + + +     + +   +   + +   + +s    + +   +   + ++
+ + + + +++++++ +++ + + + +++ + +++++ + +++++++++ ++
+ + +       +   +   + +   +   + +     +         + ++
+ + +++++++ + +++ +++ +++ + +++ + +++++++++++++ + ++
+ +   +     + +   +   +   +   + + +       + +   + ++
+ +++ +++++++ + +++++ + +++++ + + + +++++ + + +++ ++
+ +           +     + + + +   + +   +     +   +   ++
+ +++++++++++ +++++ + + + + + + +++++ +++++ +++++ ++
+     +         + + + +   + + +     +   + + +     ++
+ +++ + +++++++ + + + +++ + +++++ +++++ + + +++ + ++
+ e + + + +   +   + + +   +     +     + + +   + + ++
+++ + + + + + +++++ + + +++++ + +++++ + + +++ + + ++
+ + + + + + +   +   + +   +   +     +   + +   + + ++
+ + + + + + +++ + +++ +++++ +++++++++++++ + +++ ++++
+   + +   + + + + +     +   +   +         + +     ++
+ +++ +++++ + + + +++++ + +++ + + +++ +++++ +++++ ++
+   +         +         +     +     +             ++
++++++++++++++++++++++++++++++++++++++++++++++++++++
++++++++++++++++++++++++++++++++++++++++++++++++++++