++++++++++++++++++++++++++++++++++++++++++++++++++++
++++++++++++++++++++++++++++++++++++++++++++++++++++
+     +       +   +   +         +           +     ++
+ +++++ +++ +++ + + + + +++ +++ +++++++ +++++ +++ ++
+ +     + +     +   + + + + + +       + +       + ++
+ + +++++ +++++++++++ + + + + +++++++ + + +++++++ ++
+ +     +         + + + + + +     +   + +   + +   ++
+ +++++ + +++ +++ + + + + + + + + + +++ +++ + + + ++
+     + +   + +     + +   + + + + + +     +   + + ++
+++ + + +++++ +++ +++ +++ + +++ + + +++ +++ +++ + ++
+   + +     +   + +   +   +   + + + +   +   +   + ++
+ +++ +++++ +++ +++ +++ +++++ + +++ + +++ +++ +++ ++
+ +   +   +   +   +     +     +     +     +   +   ++
+ + +++ + +++ + + +++++++ +++e+ +++++ +++++ +++ ++++
+ + +   + +   + +     +   +     +   +   + + + + + ++
+ + +++ +++ +++++++ +++ +++ +++++ + +++ + + + + + ++
+ +     +           +   + + +     +   + + + +     ++
+ +++++++ +++++++++++ +++ + +++ +++++ + + + ++++++++
+     +   +     +     +     +   +     +   +       ++
+++++ + +++ +++ + +++++ +++++ +++++ +++++++++++++ ++
+   +     + + + +   + + +         +   +           ++
+ + +++++ + + + +++ + + +++ +++++ +++ + +++++++++ ++
+ +     + + + +     + +   +     +   +   +     +   ++
+ +++++ +++ + +++++++ +++ +++ +++++ +++++ +++ + ++++
+   + +     +           + +   +     +     +   + + ++
+++ + +++++++ +++++++++ + +++++ +++++++ +++++++ + ++
+   +       +   +       + +     +     +         + ++
+ +++ +++ + + + +++ +++++ + +++++ +++ + +++++++++ ++
+ +s+ +   + + +   + +   + +       +   + +     +   ++
+ + + + +++++ +++ +++ + + +++++++++ +++ + +++ + + ++
+   + +         +     +             +     +     + ++
++++++++++++++++++++++++++++++++++++++++++++++++++++