++++++++++++++++++++++++++++++++++++++++++++++++++++
++++++++++++++++++++++++++++++++++++++++++++++++++++
++   +       +     +   +   +     +     +       +   +
++ +++ +++ + + + +++ + + + +++ + + + + + +++ +++ + +
++   + + + +   + +   +   +   + + + + + +   + +   + +
++ + + + + +++++++ +++++++++ + + +++ + + + +++ +++ +
++ +   + +         +   +   +s+ +   + + + + +   +   +
++ +++++ +++++++++++++ + + +++ +++ + + +++ + +++ + +
++     +   +     +     + +     +     +     + +   + +
++++++ + + + +++ + + +++ +++ +++++++++++++++ + +++ +
++ +   + +   + +   +   + + +                 +   + +
++ + +++ +++++ +++++++ + + +++++++++++++++++++ + +++
++ + + +   +   + +     +     +       +   +   + +   +
++ + + +++ + + + + +++ +++++ + + +++ + +++ + +++++ +
++   +   + + + + + + +   + + + + + e + +   +   +   +
++ +++++ + + + + + + +++ + + +++ + +++ + +++++ + + +
++     +   + +   + +       + +   +     +     + + + +
++++++ +++ + +++++ +++++++++ + +++ +++++++++ + + +++
++   +   +   +   +   +         +   +         + +   +
++ +++++ +++ + + +++ + +++++++++++++ +++++++++ +++ +
++ +   +   + + +   +   +           + +       +   + +
++ + + +++ + + +++ + +++ +++++++++ + +++++ + +++ + +
++   +   + + + +   + +   +       +   +     + +   + +
++ +++++ + + + + +++ + +++ + +++ +++++ +++++++ +++ +
++   + +   + + +   + + +   + +     + +       +   + +
++++ + +++++ + +++ +++ +++++ +++++ + + +++++ +++ + +
++ +     + + + + +   +   +   +   + + + +   + +   + +
++ +++++ + + + + +++ + + + +++ + + + + + + + + +++ +
++ +   + +   + +   + + + + +   + +   + + + + +     +
++ + + + +++++ + +++ +++ + + +++ +++++ + + + +++++ +
++   +         +         +     +         + +       +
++++++++++++++++++++++++++++++++++++++++++++++++++++