++++++++++++++++++++++++++++++++++++++++++++++++++++
++     +       +               +                   +
++ +++ + + +++++ +++++++++++ +++ +++++++++ +++++++ +
++ +   + +       +     +   +     +   +     +     + +
++++ + + +++++++++ +++++ + +++++ +++ + +++ + +++ +++
++   + + +     +         + +   +     +   + + + +   +
++ +++ + +++ + +++++++++++ + + +++++ +++ + + + +++ +
++   + +     +     +   +   + +     +   + + + + +   +
++ + + +++++++++++ + + + + + +++++ +++ + + + + + + +
++ + + +       +   + +   + + +   + +   + + +   + + +
++++ +++ +++ + + +++ + +++++ + + + + +++ +++ +++ + +
++   +     + + +   + + +   + + +   +   + +   +   + +
++ +++ +++++ +++++ + + + + + +++ +++++ + + +++ +++ +
++     +   + +       + + + +   + +     +     + +   +
++++++++ + + + +++++++ + + +++ + +++++++++++++ +++++
++     + +   + +     + + +     +       +       +   +
++ +++ + +++ + + +++ + + +++++++++++++ + +++++++ + +
++ +     +   + +   + + +     +   +   + +     +   + +
++ +++++++++++ +++ + +++ +++ +++ + + + +++ + + +++ +
++   +     +   +   +   +   +   + + + +   + + + + + +
++++ + +++ + +++ +++++ + +++++ + + + +++ + + + + + +
++   + + +   + +   + + + +     + + +   + + + + + + +
++ + + + +++++ +++ + + +++ +++++ + + ++e + + + + + +
++ + + +   +   +   +       + +     +   + + +     + +
++ +++ + + + +++ + +++++++++ + +++++++ + +++++++++ +
++   +   +   +   + +s  +       + +   + + +   +   + +
++ + +++++++ + + +++++ + +++++++ + + + + + + + + + +
++ +       + + + +   + +   +   +   + + + + + + +   +
++ + +++++++ + +++ + + +++ + + +++++ + + + + + +++ +
++ +         +     +   +     +       +     +   +   +
++++++++++++++++++++++++++++++++++++++++++++++++++++
++++++++++++++++++++++++++++++++++++++++++++++++++++