++++++++++++++++++++++++++++++++++++++++++++++++++++
++     +             +     +       +       +       +
++ +++ + +++++++++++ + +++ + + +++ +++++ + +++++ + +
++   + + +   +       +   +   +   +       +       + +
++ + + + + +++ +++++++++ +++++++ +++++++++++++++++ +
++ + +   +     +         +     +     +   +       + +
++++ +++++++ +++ +++++++++ +++ +++++ + + +++++ +++ +
++   +     + +   +     +     +     + + +       +   +
++ +++ +++ +++ +++++++ + +++++++++ + + +++++++ + +++
++       +   + +     + + + +       + + +   + + + + +
++ +++++++++ + + +++ + + + + +++++++ + + + + + + + +
++ +         +   +   +   + +   +     +   + +   +   +
++++ +++++++ +++++ +++++ + +++ + +++++++++ + +++++ +
++   +     + +   +     +     + + +         +   +   +
++ +++ + + + +++ +++++ + +++++ + +++++ +++ +++++ +++
++   + + + +     + +   + +     +   +   +   +   + + +
++ + +++ +++++++ + + +++ + +++ +++ + +++++++ + + + +
++ +   +       +   +   + + + + + + +         + + + +
++ +++ + + +++++++ +++ + + + + + + +++++ +++++ + + +
++   + + +   +     +   + + +   + +     +     + +   +
++++++ + +++ + +++++ +++++ + +++ +++++ +++++++ +++ +
++     +   e   +   +   +   +         +   +   +     +
++ +++++ +++++++ + +++ + +++++ +++++++ + + + + +++++
++   +   +     + + +   + +   + +    s+ + + + +     +
++++ + +++ +++ + + + +++ + + + + +++++ + + + +++++ +
++   +   + + +   +   +     + + +   +   +   + +   + +
++ +++++ + + +++++++++ +++++ + +++ +++++++++ + + + +
++   +   +   +   +   +   +   +   +   +     + + +   +
++ + +++++++ + + + + +++++ +++++ +++ + +++ + + +++++
++ +           +   +       +       +   +     +     +
++++++++++++++++++++++++++++++++++++++++++++++++++++
++++++++++++++++++++++++++++++++++++++++++++++++++++