++++++++++++++++++++++++++++++++++++++++++++++++++++
++++++++++++++++++++++++++++++++++++++++++++++++++++
++ +       +     +       +     +     +       +     +
++ + + +++ +++ + + +++++ + +++ + + +++ +++ +++ + +++
++ + +   + +   + + +   +     +   +   +   + +   +   +
++ + +++ + + +++ + + + +++++++++++++ +++ + + +++++ +
++   + + + + +   +   +   + +         +   +   +     +
++ +++ + + + + +++++++++ + + +++++++ + +++++++ +++ +
++ +   + +   +       +     + +     + +   +   + +   +
++ + +++ + +++++++++ +++ +++ + +++++ +++ +++ + +++++
++ +   + + +   +       + +   +       +       + +   +
++ +++ + +++ + +++++++ +++ +++++++++++ +++++++ + + +
++     +     +       +     +         + + +     + + +
++++++ +++++++++++++ +++++++ +++++++ + + + +++++ + +
++   +   +   +     + +       +     +     + +     + +
++ + +++ + + + +++ + + +++++++++ + +++++++ + +++++ +
++ +     + + + + + + + +   +     +   +   + +     + +
++++++ +++ + + + + + + + +++ + +++++ + + + +++++ + +
++   + +   + + +     + +     +   + + + + +       + +
++ + + + +++ + + +++++ +++++++++ + + + + + +++++++ +
++ + + + +   + + +               +   + + + + +   + +
++ + +++ + +++ +++ +++++++++++++++ +++ + + + + + + +
++ +     +   +     +             + + + + +   + +   +
++ +++++++++ +++++ + +++++++++++ + + + + +++++ +++ +
++     +   +     + +     +       +   + +       + + +
++++++ + + +++++ +++ +++ +++ +++++++ + +++++++++ + +
++ +   + +     +   +   +   +       + +   +       + +
++ + +++++++ + +++ +++++++ +++++++ +++++ + + +++++ +
++  e+   +   + + +  s+     + +   + +   + + +       +
++ +++ + + +++ + +++++ +++++ + + + + + + + +++++++++
++     +   +           +       +     +   +         +
++++++++++++++++++++++++++++++++++++++++++++++++++++