++++++++++++++++++++++++++++++++++++++++++++++++++++
++++++++++++++++++++++++++++++++++++++++++++++++++++
++   +               +                 +       +   +
+e + + +++++++ +++++ + +++++++++++ +++ +++++ + + + +
++ + + +     + +     + +     +   + +   +     + + + +
++ + + + +++++ +++++++ + +++ + +++ + +++ +++++ +++ +
++ +   +     +         + + + +   + +     +   +     +
++ +++++++ + +++++++++++ + + +++ + +++++ + + +++++ +
++ +     + +             +   +   + +     + + +   + +
++ + +++ +++++++ +++++++++ +++ + + +++++++ + + + +++
++   +   +   +   +   +     +   + +   +     +   +   +
++++++ +++ + + + + + +++++ +++ + +++ + +++++++++++ +
++   +   + +   + + +     +     + +   +   +   +   + +
++ +++++ + +++++ + +++++ +++++++++ +++++ + + + + + +
++ +   +   + +   +   +   +   +   +     +   +   + + +
++ + + +++++ + +++++ +++ + + + + +++++ + +++++++++ +
++   +       + +   +   +   + + +     + + +     +   +
++ +++++++ +++ + + +++ +++++ + +++++ + + + +++ + + +
++ +   +   +     +   +   +   + +   + +   +   +   + +
++ + + + + + +++++++ +++ + +++ + +++ + +++++ +++++++
++ + + + + + +   +   +   +     +     +     +       +
++ + + + +++ + + +++ + +++++++++ +++++++++++++++++ +
++ + + +     + +   + + +       + +         +     + +
++ + +++++++++ +++ +++ + +++ +++ + +++ +++ + +++ + +
++ +         + +       +   +   + + +   +s+   + + + +
++ +++++ +++ + +++++++++++ +++ + + +++++ +++++ + + +
++   +   + + +       +       +     +     +     +   +
++++ + +++ + +++++++ +++++++++++++++ +++++ +++ +++ +
++   +   +   +     +       +         + +   + +   + +
++ +++++ + +++++ + +++++++ + +++++++++ + +++ + +++ +
++       +       +       +   +               +     +
++++++++++++++++++++++++++++++++++++++++++++++++++++