++++++++++++++++++++++++++++++++++++++++++++++++++++
++++++++++++++++++++++++++++++++++++++++++++++++++++
+   +         +           + +         +         + ++
+ + + + +++++++ + +++++++ + + +++++ +++ +++++ + + ++
+ + + +       + + +   +     + +   + +       + + + ++
+ +++ +++++++ + + + + +++++ + + + + + +++++++ + + ++
+ +   +     + + +   +   +   + + + +   +       +   ++
+ + +++ +++++ + +++++++ + +++ + + +++++ +++++++++ ++
+   +   +     +       + + +   + +   +   +   +     ++
+ +++ +++ + +++++++++ + + + +++ +++ + +++++ + ++++++
+   +   + + +         + + +   +   + +     +       ++
+++ +++ + + + +++++++++ + +++ +++ + +++ + +++++++ ++
+ + +   + + + +     +   + +   +   +   + +       + ++
+ + + +++ +++ +++ +++ +++++ +++ +++++ +++++ +++ + ++
+ + +   +         +   +   + +   +         +   + + ++
+ + +++ +++++++++ + +++ + + + +++++++++++ +++ + + ++
+ +         +   + +   + +   + +     +       + + + ++
+ +++ +++++ + + +++++ + +++++ + +++ +++++++ +++ ++++
+     +   + + +       + +   +   + +       +     +s++
+ +++++ + +++ +++++++ + +++ +++++ +++++++ +++++++ ++
+ +   + +     +       + +     +         +   +     ++
+ + + + +++++++++++ +++ + +++ +++ + +++ +++ + ++++++
+ + +   +         +   +   + +   + +   + + +   +   ++
+ + +++++ +++++++ +++++++++e+++ + +++ + + +++++ ++++
+ +       + +     +     +   +   + +   +     +     ++
+ +++++++++ + + +++ + + +++ + +++++ +++++++ +++++ ++
+   +     + + + +   + +     + +     + +   + +     ++
+++ + + + + + +++ +++ +++++ + +++ +++ + + + + +++ ++
+   + + +   +     + +   +   +   + +   + +   + +   ++
+ +++++ +++ +++++++ +++ +++++++ + + + + +++++ + ++++
+       +             +           + +         +   ++
++++++++++++++++++++++++++++++++++++++++++++++++++++