++++++++++++++++++++++++++++++++++++++++++++++++++++
++++++++++++++++++++++++++++++++++++++++++++++++++++
+s    +   +         +   +       +       +   +     ++
+++++ + +++ + +++++++ + + + +++ + +++++ + + +++ + ++
+   + + +   +         + + +   + + +     + +   + + ++
+ +++ + + +++++++++++++ + +++ + + + +++++ +++ +++ ++
+ +   +   +         +   +   + +   +     + + +     ++
+ + +++ +++++ + + +++ + +++ + +++++++++ + + +++++ ++
+ +   +     + + + +   + +   +   +     +   +     + ++
+ +++ +++++ +++ + + +++ + +++++ + +++ +++++ +++ + ++
+   +   + +     + +   + +   +   +   +   +     +   ++
+ + +++ + +++++++ +++ + +++ + +++++ +++ +++++ ++++++
+ + +   +   +   + +   + +   +         + +   +     ++
+++ + +++ + + + + + +++++ +++++++++++++ + + +++++ ++
+   + +   + + +   +   +       +   +   +   + +     ++
+ +++ +++++ + +++++++ + +++++++ + + + +++ + +++ ++++
+   + +     + + +   +   +       +   +   + +   +   ++
+ + + + +++++ + + + +++ + +++++++++++++ + +++ +++ ++
+ +   +     + + + +   + +             + +   + +   ++
+ +++++ +++ + + + +++ +++++ +++++++++ + +++ + + ++++
+ +   +   + + + + + +     + +       + +   + + + + ++
+ + + +++ + + + + + +++++ + + +++ +++ +++ +++ + + ++
+ + +   + +     + +     + + + +   +   + + +   +   ++
+ + +++ +++++++++ +++++ + + +++ + + +++ + + +++++ ++
+ + +   +       + +   + + +     + + +   +   +   + ++
+ + + +++ +++++ + + + + + +++++++ + + + +++++++ + ++
+   + +   +   +   + +   + +       + + + +       + ++
+++++ + +++ +++e+++ +++++ +++++++++ +++ + +++ +++ ++
+   +   +   +           +         +   +   + +     ++
+ + +++++ + + +++++++++ +++++++++ +++ + +++ ++++++++
+ +       +           +               +           ++
++++++++++++++++++++++++++++++++++++++++++++++++++++