++++++++++++++++++++++++++++++++++++++++++++++++++++
+   +   +       +             +           +   +   ++
+ +++ + + +++++ +++ + +++++++++ +++++++ + + +++ + ++
+   + +   +   +   + +   +       +     + + + +   + ++
+ + + +++++++ +++ +++++ + +++++++ + +++ + + + +++ ++
+ +   +       + + +   +           + +   + +   +   ++
+ +++++++ +++ + + + + +++++++++++ +++ +++ + +++ ++++
+ +   +   +   + +   +       +   + +   +   +   +   ++
+ + + + +++ +++ +++++++++++ + + +++ +++++ +++ +++ ++
+ + +   +   +           + + + + +   +   + +   +   ++
+ + +++++ +++++++ + +++ + + + + + +++ + + + +++ ++++
+   +   +       + +   +   + + +s+     + + +   +   ++
+++++ + +++++++ + +e+ +++ + + +++ +++++ + +++++++ ++
+ +   +   +     +   + +   +   + +   +   +         ++
+ + + +++++ +++++++ + + +++++++ +++ + +++++++++++ ++
+   + +     +   +   + +           + +   +   +   + ++
+++++ + +++++ + + +++ +++++++++++ + +++ + + +++ + ++
+     + +     + + + + +       +   +   +   +   +   ++
+ +++++ + +++++ + + + + +++++ +++++++ +++++++ ++++++
+     + +   + + +   + + + +   +     + +     +     ++
+ +++ + + + + + +++ + + + + +++ + +++ + +++ +++++ ++
+   +   + + +   +   +     +     +   + +   +   +   ++
+++ +++++++ + +++++++++++++++++++++ + +++++ + + ++++
+ + +     + + +               +     +   +   + +   ++
+ + + +++ + + +++ +++++++++++ + +++++++ + + +++++ ++
+ +   +   + +     +     +     + +         + +   + ++
+ +++++ +++ +++++++++++ + +++++ + +++++++++++ + + ++
+     +   +         +   +   +     +         + +   ++
+ + +++++ +++++++++ + +++++ +++++++ +++++++ + +++ ++
+ +                 +               +         +   ++
++++++++++++++++++++++++++++++++++++++++++++++++++++
++++++++++++++++++++++++++++++++++++++++++++++++++++