++++++++++++++++++++++++++++++++++++++++++++++++++++
++   +   +s          +   +   +       +     +   +   +
++ + + +++++++++++++ + +++ + + +++ +++ + + + + + + +
++ + +       +     + +     + + + +     + +   +   + +
++ + +++ +++++ +++ + +++ +++ + + +++++++ + +++++++ +
++ +   +       +   +   +   +           + + +   +   +
++ +++ +++ +++++ +++++ + +++++++++++++ + +++ + +++++
++   +   +     + +   + + +   +         +   + +     +
++ + +++ +++++++ + + + +++ + + +++++++++++ + +++++ +
++ +   +       +   + +     + +     +   + +       + +
++ +++ +++++++ +++++ +++++++ +++++ + + + +++++++++ +
++ + +   +   +       +     + +       +   +       + +
++ + +++ + + +++++++ + + +++ +++++ +++++++ +++++ + +
++ +   + + +         + +   +     + +       +   +   +
++ + + + +++ +++++++++++++ +++++ +++ +++++++ + +++ +
++   + +   +   +         +     +     +       + +   +
++++++ +++ +++ +++ +++++ + +++++++++++ +++++++++ +++
++   + + +   +     +     + +           +       + + +
++ + + + +++ +++++++ +++++ + +++++++++ + +++++ + + +
++ + + +   + +       +     + +       +   +     +   +
++ + + +++ + +++++ +++ +++ + + +++++ +++++ +++++++ +
++ + + +   +     + +   +   + +   + + +   + +       +
++++ + + + +++++ + +++++ + + +++ + + +++ + + +++++++
++   + + + +   + +       + +     + + +   + +       +
++ +++ + +++ + + + +++++++++++++++ + + + + +++++++ +
++   +   +   +   + +   +     +     + + + +       + +
++ + +++ + +++ +++++ + + + + + +++ + + +++ +++++++ +
++ +   + + +   +   + + + + + + + +   +   +         +
++ + +++ + +++++ + + + + + +++ + +++++++ +++++++++++
++ +     +       +   +   +                         +
+++++++++++++++++++++++++++e++++++++++++++++++++++++
++++++++++++++++++++++++++++++++++++++++++++++++++++