++++++++++++++++++++++++++++++++++++++++++++++++++++
+     +           +       +                       ++
+ +++ + +++++++++++ + +++ + +++++++++++++++++++ + ++
+ +   + +   +       +   + + + +     +         + + ++
+ + +++ + + + +++++++++ + + + + +++ + +++++++ + + ++
+ +     + +   +       + + +   + +   + +     +   + ++
+ +++++ + +++++ +++++ + +++++ + + +++ + +++ +++++ ++
+     + +   +   +     +   +   + +   + + + +     + ++
+ +++ +++++ +++++ +++++++ + +++ +++ + + + + +++ + ++
+ + +             +     + +   +   +   + + +   + + ++
+ + +++++++++++++++ +++ + +++ +++ +++++ + +++ +++ ++
+     +   + +     +   + +   + + + +   +   + +     ++
+++++ + + + + +++ + +++ + + + + + + +++++ + ++++++++
+ +   + + + + + +   +   + + + + + +     +         ++
+ + +++ + + + + +++++ +++ + + + + + + +++++++++++ ++
+ +     + + + +     + +   +   + + + +         +   ++
+ +++++++ + + +++++ + +++ +++++ + + +++++++ +++ ++++
+       +   + +     +   + +     + +     +   +   + ++
+ +++++ + +++ + +++++++ + +++++ + +++++ + + + +++ ++
+   +   + +   + +    s+ +       +   +   + + + +   ++
+ + +++++ + +++ + +++++ + +++++++++ +++++ +++ +++ ++
+ +       +   + + +     + +   +   +     +     +   ++
+ +++++++++++ + + +++ +++++ + + + +++++ + +++++ + ++
+     + +     + +     +     +   +     + +       + ++
+++++ + + +++++ +++++++ +++++++++++++ + +++++++++ ++
+   +   +           +   +     +       +   +     + ++
+ + +++ +++++++++++ +++ + + +++ +++++++++ + ++e++ ++
+ +   + +         +   + + +     +         +   +   ++
+ +++++ +++ +++++ +++ + + +++++++++++++ +++ + + ++++
+           +       +   +               +   +     ++
++++++++++++++++++++++++++++++++++++++++++++++++++++
++++++++++++++++++++++++++++++++++++++++++++++++++++