++++++++++++++++++++++++++++++++++++++++++++++++++++
+   +         +                       +           ++
+ + + +++++++ + +++++++++++++++ +++++ + +++++ + + ++
+ + + +     + +     +           +   + + +   + + + ++
+ +++ + +++ + +++++ + +++++++++++ + + +++ + +++ + ++
+   + +   +   + +   +     +     + +   +   +     + ++
+++ + +++ +++++ + +++++++ + + +++ +++++ +++++++++ ++
+   + + +  s+     + +     + +   +       +     +   ++
+ +++ + +++++ +++++ + +++++ +++ +++++++++ + +++ ++++
+     +   +   +   + +   +     + +     +   +     + ++
+ +++++++ + +++ + + +++ +++++ + + + +++ +++++++++ ++
+   +   + +     +   + +     + +   + +   + +       ++
+++ + + + +++++++++ + +++++ + +++++ + +++ + + ++++++
+   + + +           +     + + +   + + +   + +     ++
+ +++ + +++ +++++++++ +++++ + +++ + + +++ + +++++ ++
+ +   +   +         + +     +     + +   +       + ++
+ + +++++ +++++++++ + + +++++++++++ +++ +++++++++ ++
+   +   +       +     + +       +   +   +         ++
+++++ + +++++++ +++++++ +++++ + + + + +++ +++++++ ++
+     + +       +     +     + +   + + +   +       ++
+ + +++++ +++++++ +++ + +++ + +++++ e + + + ++++++++
+ +     +   +     + + + +   +   +   + + + + +     ++
+++++++ +++ + +++++ + + + +++++ + +++ + + + + +++ ++
+       +   + +   +   + + +     +   + + + + + +   ++
+ +++++ + +++ + + + +++ + + +++++++++ +++ + +++ + ++
+   + + + +   + + + +   + +         +     +     + ++
+++ + + + + +++++ + +++ + +++ +++++ +++++++++++++ ++
+   +   +   +     +   + +   + +   +     +     +   ++
+ +++++++++++ + +++++ +++++ + +++ +++ +++ +++ + ++++
+             +             +       +       +     ++
++++++++++++++++++++++++++++++++++++++++++++++++++++
++++++++++++++++++++++++++++++++++++++++++++++++++++