++++++++++++++++++++++++++++++++++++++++++++++++++++
++++++++++++++++++++++++++++++++++++++++++++++++++++
+     +           +       +       +       +       ++
+ +++ + + +++++++++ + + +++ + +++ +++ +++ + + +++ ++
+ +     + +     +   + + +   + +       + + + +   + ++
+ +++++++ + +++ + +++ +++ +++ +++++++++ + +++ + + ++
+     +   + + + +   +   + + +         + +   + + + ++
+ +++ +++++ + + +++ +++ + + +++++++++ + +++ +++ ++++
+   +       + +   + + +   +   +       +   +   +   ++
+++ +++++++++ + +++ + +++++ +++ +++++++++ +++ +++ ++
+e+ +         +     +     +   +     +       + +   ++
+ + +++++ +++ +++++++ +++ +++ +++++ + +++++ + + + ++
+ +     + +   +   +   +     +     + +     + + + + ++
+ +++++ + + + + + + + +++++ +++ + + +++ + +++ + ++++
+     + + + +   +   + +   +     + +   + + +   +   ++
+ +++++ + + +++++++++ + + +++++++++++ + + + +++ + ++
+   +   + + + +       + +             + +   +   + ++
+++ + +++++ + + +++++++ +++++++++++++++ +++++ +++ ++
+   + +     +   +   +   +     +     +   +       + ++
+ +++ +++ +++++++ + + +++ + +++ + +++ +++++++ +++ ++
+ +   +   +       +   + + +     + +         + +   ++
+ + +++ +++ +++++++++++ + +++++++ + +++++++ +++ + ++
+ + +   +   +     +             +   +  s+ +     + ++
+ + +++ + +++++ + + +++++++++++ +++++ +++ +++++++ ++
+ +     +     + +   +       +   +   + + +     +   ++
+ +++++ +++++ +++ +++ +++++ +++ + +++ + + +++ + ++++
+ +     +   +   + +   +   +   +   +   + +   +   + ++
+ + +++++ + +++ +++ +++ +++++ +++++ +++ +++ +++++ ++
+ +     + +   + +   + +     +       + +   + +     ++
+ +++++ + +++ + + +++ + + +++++++++++ + + + +++++ ++
+         +   +   +     +               +         ++
++++++++++++++++++++++++++++++++++++++++++++++++++++