++++++++++++++++++++++++++++++++++++++++++++++++++++
+         +           +       +       +   +     + ++
+ + +++++ + + +++++++ +++++ +++ +++++ + + + + + + ++
+ +     + + +       +       +   +   + + + + + +   ++
+ +++++ + + +++++++ +++++++++ +++ +++ + + + + ++++++
+   +   + +     + + +         +     + + +   +     ++
+ +++ + +++++++ + + + +++++++++ +++ + + +++++++++ ++
+ +   + +       + +   +   +   + + + +     +   +   ++
+ + +++ + +++++++ +++++ +++ + + + + +++++++ + + ++++
+ + +   +     +       +     +     +     +   +   + ++
+ + +++++++++ + +++++ +++++ +++++++ +++++ + +++++ ++
+ +         + + +   +     +   +     +     + +   + ++
+ +++++ +++ + + + +++++++ +++++ +++ + +++ +++ + + ++
+ +   +   + + + +     +   +   + + + +   + +   +s+ ++
+ + + +++ + + + +++++ + +++ + + + + +++ +++ +++++ ++
+   + + + + + +   +   +   + +   + + + +     +     ++
+++++ + + +++ + + + + +++ + +++++ + + +++++++ + + ++
+       +   + + + + + +   +   +   + +   +   + + + ++
+ +++++++++ + +++ + + + +++++ + + + + + + + +++ + ++
+ + +     + + +   + + +       + + +   + + +     e ++
+ + + +++ + + + +++ +++++++++++++ +++++ + +++++++ ++
+ + + +     + +   +             +     + +     +   ++
+ + + +++++++ +++ + +++++++++ + +++++ + +++ + ++++++
+   + +       +   + +   +     +       +   + +     ++
+++++ + +++++++ +++ + + + +++++ +++++++++ +++ +++ ++
+     + +       +   + + +     + +       +   + +   ++
+ +++++ +++ +++++ +++ + +++++ + + +++ +++++ +++ ++++
+ +     +   +   + +   +   +   + + + +     +   +   ++
+ + +++++ +++ +++ +++ +++ + +++++ + +++++ +++ +++ ++
+         +           +   +             +         ++
++++++++++++++++++++++++++++++++++++++++++++++++++++
++++++++++++++++++++++++++++++++++++++++++++++++++++