++++++++++++++++++++++++++++++++++++++++++++++++++++
+                 +   +     +         +     + +   ++
+++++++++ +++++ + + + + + +++ +++++ +++ +++ + + + ++
+       + +     + + + + +     +   +     +   +   + ++
+ +++++ + + +++++++ + + +++++++ +++++++++ +++++ + ++
+   + + + + +       +     +             +     + + ++
+++ + + +++ + +++++++++++ +++++ +++++ +++++++ +++ ++
+   +       + + +s      +     +   + +       + +   ++
+ +++++++++ + + +++++++ +++++ +++ + +++ +++++ + + ++
+ +   +   + + +   +   + +   +   +   +   +     + + ++
+ + + + +++ + + +++ + + + + +++ +++++ + + +++++ + ++
+ + + +     + +   + +   + +   + +     + +   e   + ++
+ + + +++++++ +++ + +++++ +++ + + +++++ +++ + + + ++
+ + +       +   + +   +   + + + +     +   + + + + ++
+ + +++++++ +++ + +++ + +++ + + + +++ +++ + + + ++++
+   + +       +   + +   +     + +   + + + + + +   ++
+ +++ + +++++++++ + +++++ +++++ +++++ + + + +++ + ++
+     +   +       +     +   +         +   +   + + ++
+++++ +++ + +++++++ +++++++ +++++++ +++++++++ + + ++
+   + + +   +     +       +     + + +         + + ++
+ +++ + +++++ +++ + +++ +++++++ + + + +++++++++++ ++
+   + +   +   + + +   +       + +   + +         + ++
+ + + + + + +++ + +++ +++++++ + +++ + +++++ +++ + ++
+ + + + +       +   +   + +   +   + +   +   + + + ++
+++ + +++++++++ + +++++ + + + +++ +++++ + +++ + + ++
+   +       +   +         + + + +       +   + + + ++
+ +++++++++ + +++++++++ +++ + + +++++++++++ + + + ++
+ +     +   + +       + +   +     +         + +   ++
+ + + +++ +++++ +++++ +++ +++++++ +++++++ +++ +++ ++
+   +           +         +               +       ++
++++++++++++++++++++++++++++++++++++++++++++++++++++
++++++++++++++++++++++++++++++++++++++++++++++++++++