++++++++++++++++++++++++++++++++++++++++++++++++++++
+ +   +   +     +           +     +           +   ++
+ + + + + + + + + + +++++++ +++ + +++++++ +++ +++ ++
+ + +   +   + + + + +     +     +     +   + + +   ++
+ + +++++++++ + + + + +++ +++++++++++ + +++ + + + ++
+         +   +   + + +   +     +   + +   + + + + ++
+ +++++++++ +++++ +++ + +++ +++++ + + + + + + + ++++
+ +       + +     +   + + +       + + + + +   +   ++
+ + +++++ + +++ +++ +++ + + +++++++ + +++ + +++++ ++
+ +   + + +   + +   +   + +       + +     +       ++
+ +++ + + +++ + + +++ +++ +++ +++++ +++++++++++++ ++
+ +   +   +   + + + +   +   + +     +         + + ++
+e+ +++++ + + +++ + +++ + + + + +++++ + +++++ + + ++
+   +   +   + +     +   + +   +       + +       + ++
+ +++ + +++ +++ +++++ +++++++++++ +++++ +++++++++ ++
+ +   +   + +   + +   +         + +   +   +   +   ++
+ + +++++ +++ +++ + +++ +++++++ +++ + + + + + + ++++
+ + +   + +       +   +   +   + +   + + + + +   + ++
+ + + +++ + +++++ +++ +++ + + + + +++ +++ + +++++ ++
+ +   +   + +   + +     +   + +     +   +     +   ++
+ +++ + +++ + + +++ +++ +++++ +++++++++ +++++ + + ++
+   + +   + + +     +   +       +     +     +   + ++
+ + + +++ + + +++ +++++++ +++++++ +++ +++ + +++++ ++
+ + +   +   +   + +     +     +   + +   + +   +   ++
+++ +++ +++++++ + + +++ +++++ + +++ +++ +++++ + ++++
+     + +     + + + + +     + + + +   +     + + + ++
+ +++++ +++++ + +++ + + +++++ + + + + +++++ + + + ++
+       +   + +     + +   +   +s+   +     +   + + ++
+ +++++++ + + +++++++ +++ + +++++ +++++++ +++++ + ++
+         +             +   +           +         ++
++++++++++++++++++++++++++++++++++++++++++++++++++++
++++++++++++++++++++++++++++++++++++++++++++++++++++