++++++++++++++++++++++++++++++++++++++++++++++++++++
++++++++++++++++++++++++++++++++++++++++++++++++++++
++   +   +         +     +         +           +   +
++ + + + +++++++ + + + + +++++ +++ + + +++++++ +++ +
++ +   +   +   + e   + +     +   + + +   +   +     +
++ +++++++ + + +++ +++ +++++ +++ +++ +++ + + +++++ +
++ +     + + +   + + + +         +     + + +     + +
++ + + + + + +++ + + + +++++++++++ +++++ + +++++++ +
++ + + + +   + + +   + +       +   + +   +         +
++ +++ +++++++ + + +++ + +++++ + +++ + +++++ +++++++
++   +       +   + +   + + +   + +   +     +       +
++++ + +++++ + +++++ + + + + +++ +++ +++++ +++++++++
++   +   +   +   +   + + + + +   +   + +   +       +
++ +++++ + +++++ + +++ + + + + +++ + + + +++ +++++ +
++ +     +       + +   +   + +     +   +       +   +
++ +++ +++++++++++ + +++++ + +++++++++ +++++++++ + +
++   +   +     +   +   +   +   +   +   +   +     + +
++++ +++ + +++ + + +++++ +++ + +++ + +++++ + +++++ +
++   + + +   +   + +       + +     +       +   + + +
++ +++ + +++ +++ +++ +++++ + +++++ +++++++ +++ + + +
++   + +     +   +   +   + +   +         + + + +   +
++++ + +++++++ +++ +++ + + +++ +++++++++++ + + + +++
++   +       +   + +   + +   + +             + +   +
++ +++++ + +++ +++ + +++ +++++ + +++++++++++ + +++++
++ +     + +   +   + + +     + +     +     + + +   +
++ + + +++++ +++ +++ + +++++ + +++++ + +++ +++ + + +
++ + +     + +   + + +           +   +  s+   +   + +
++ +++ +++ + + +++ + +++++++ +++++ +++++++++ +++ + +
++   +   +   + +   + +     + +     +     + +   + + +
++ + +++++++++ + + + + +++ +++ +++++ +++ + +++ +++ +
++ +             + +     +           +       +     +
++++++++++++++++++++++++++++++++++++++++++++++++++++