++++++++++++++++++++++++++++++++++++++++++++++++++++
++++++++++++++++++++++++++++++++++++++++++++++++++++
++           +             +   + +             +   +
++ +++++ +++ + +++++ +++ +++ + + + +++++ + +++ +++ +
++ +     + + +     +   + +   + +   +   + +   +     +
++++ +++++ + +++++ +++ + + +++ + +++ + +++++ +++++ +
++   +           +   + + +   + + +   +     +     + +
++ +++++++ +++++ +++++ +++++ + + + +++++++ + +++ +++
++ +     + +   +     +     +s+ + +   +     + + +   +
++ + +++ + + + +++++ +++ +++++ + +++ +++ +++ + +++ +
++ +   + + + +     +     +     + + +   + +       + +
++ +++ + + + +++++ +++++++ +++++ + +++ + + +++++++ +
++   + + + +   +   +   +   + +     +   + +   +     +
++++ + + +++++ + +++ + + +++ + +++++ +++ +++++ +++ +
++   + + +     +     + + +       +   + +       + + +
++ +++ + + +++++++++++ + +++++++++ +++ +++++++++ + +
++     +   +     +   + + +         +             + +
++ +++++++++ + + + + + + + +++++++++ +++++++++++ + +
++ +         + + + + + +   +         +     +     + +
++ +++++++ +++ + + + + +++++ +++ +++++ +++++ +++++ +
++       + +   + + +     +   + +     +     +   +   +
++++++++ +++ +++ + +++++++ +++ +++++ + +++ +++ + +++
++ +   + +   +   +       +   +   + + +   +     + + +
++ + + + + +++ +++++++++ +++ + + + + +++ +++++++ + +
++   +   +   + +       +   +   +   +   + +     +   +
++ +++++++++ + +++ + +++++ +++++++ +++ + +++++ +++ +
++           +   + +     + +   +   + + + +       + +
++++++++++++++++ +++++++ + + + + +++ + + + +++++++ +
++     +         +   +   +   +   +   + +   +       +
++ +++ + +++++++++ + + + +++++++++++ + +++++ +++++++
++   +        e    +   +             +             +
++++++++++++++++++++++++++++++++++++++++++++++++++++