++++++++++++++++++++++++++++++++++++++++++++++++++++
++++++++++++++++++++++++++++++++++++++++++++++++++++
+     +       +     +         +                   ++
+ +++ +++ + +++ +++ + +++++++ + +++++++++++++++ + ++
+ +     + +     + + + +   +   +   +         +   + ++
+ +++++ +++ +++++ + + + +++ +++++ + +++++ +++ +++ ++
+     +   + +     +     +   +     + +   + +   +   ++
+++++ +++ + + +++ +++++++ +++ +++++ + + + + +++ ++++
+   + + + +   +   + +     +   +   + + +   + +     ++
+ + + + + +++++ +++ + +++e+ +++ +++ + +++++ ++++++++
+ + + +   +   +     +   + + +       +     +       ++
+ + + + +++ + +++++++ + +++ + +++++++++++ +++++++ ++
+ +   +     +   +   + + +   +     +       +       ++
+ +++++++++++++ + + +++ + +++++++++ +++++ + ++++++++
+ +     +     +   +   + + +         +   + +       ++
+ + +++ +++++ +++++++ + + +++ + +++++ +++ +++++++ ++
+     +     +         +       + +   +   +       + ++
+++++++++++ + +++++++++ +++++ +++ + +++ +++++ +++ ++
+   +       + +     +   +   + +   +   +       +   ++
+ + + +++++++ + + +++ +++ + +++ +++++ +++++++ + ++++
+ +   +     + + + +   +   + +   +   +       + +   ++
+ +++++ +++++ + +++ +++ +++ + +++ +++++++++ + +++ ++
+ +   +   +   +   + +   + + +   +       +   + + + ++
+ + + +++ + +++ + + + +++ + +++ + + +++++ +++ + + ++
+ +s+   +   +   +   + +   + +   + +   +   +     + ++
+ +++++ + +++ +++++++ +++ + + +++++ + + +++++++++ ++
+       + +   +     +   +   +     + + + +         ++
+++++++++ +++++ +++ + + + +++++++ + + + + + +++++ ++
+ +     +     +   + + + + +       + +   + + +     ++
+ + +++ +++++ +++ + +++ + +++ +++++ +++++++ + ++++++
+     +           +     +     +             +     ++
++++++++++++++++++++++++++++++++++++++++++++++++++++