++++++++++++++++++++++++++++++++++++++++++++++++++++
++++++++++++++++++++++++++++++++++++++++++++++++++++
++     + +       +   +             +   +       +   +
++ +++ + + +++ + +++ + +++++ +++++ + + + + +++++ + +
++ +     + + + +   + + +   +     +   + + +       + +
++ +++++++ + + +++ + + + + +++++ + +++++ +++++ +++ +
++     +   + + +     + + + +     + +     +   +   + +
++ +++ + +++ + +++++++ +++ + +++++++ +++++ + +++++ +
++   + +     + +       +   +   +   + +   + +       +
++ +++ +++++ + + +++++++ +++++ + + + + + + +++++++++
++ +     +   + + +       +   +   + + + +s+ +       +
++ + +++++ +++ + + +++ +++ + +++++ + + +++ + +++++ +
++ +     +   + + + +   +   +     +   + + +   +   + +
++ +++++ +++ + + + +++ + +++++++ +++++ + + +++ +++ +
++     +     + + + e + +   +         + + + +   +   +
++ +++++++++++ + + + +++++ + +++++++ + + + + +++ +++
++ +           + + +       + +     + + +     +   + +
++++ +++++++++ + + +++++++++ + +++++ + + +++++ +++ +
++   +   +     + + +     +   +     + + + + +   +   +
++ +++ + + +++++ + + +++ + +++++ + + + + + + +++ + +
++ +   + + +     +   +   +     + + + + +   +   + + +
++ + + +++ + +++++++++ +++++++ +++ + + +++++++ +++ +
++ + +     +     +   +       +   + + + +   +   +   +
++ + +++++++++++ + + + +++++++++ + + + + + + +++ + +
++ + +     +     + + + +     +   +   +   +   +   + +
++ + + + +++ +++++ + +++ +++ + +++ +++++++++++ +++ +
++ +   + +   +     +     + +   + +           + + + +
++ + +++++ +++++ +++++++++ +++++ +++++++++++ + + + +
++ + +     +   + + +             +           + + + +
++ +++ +++++ + + + + +++++++++ +++ +++++++++++ + + +
++           +   +           +                 +   +
++++++++++++++++++++++++++++++++++++++++++++++++++++