++++++++++++++++++++++++++++++++++++++++++++++++++++
+   +             +         +           +       + ++
+ + + +++++++++++ +++++ +++++ +++++++ + + + +++ + ++
+ + +         + + +s  +       +     + + + + + +   ++
+ +++++++++++ + + +++ + +++++++++ +++ + +++ + +++ ++
+       + +   + +   + +     +     +   +   + +   + ++
+ + +++ + + +++ +++ + +++++ +++ + + +++++ + + +++ ++
+ +   + + +   +   +   +   +     + + +   +   +   + ++
+ +++ + + +++ + + +++++ + +++++++ + +++ +++++++ + ++
+ +   + +   +   +       +     + + +   +         + ++
+ + +++ + + +++++++++++++++++ + + +++ +++++ +++++ ++
+ +   +   + +     +       +   + +e+ +   +   +   + ++
+ +++ +++++ + +++ + +++++ + +++ + + +++ + +++ + + ++
+   + +   + + +   + +   +   +   +     + + +   +   ++
+++++ + + + + + +++ + + +++++ +++++++ + + + +++++ ++
+     + +     + +   + +   +           + +   +   + ++
+ +++++++++++++++ +++ +++ +++++ +++++ + + +++ + ++++
+   +           +   + +   +   + +   + + +   + +   ++
+ + + +++++++++ +++ + +++ + + +++ + +++ +++++ +++ ++
+ + + +     +     + +   +   +     +   +         + ++
+ + + + + + + +++++ +++ +++++++++++++ +++++ +++++ ++
+ +   + + + + +     +   + +         + +   +   +   ++
+ +++++ + +++ + +++++ +++ + +++++++ + + + +++++ ++++
+     + + +   +   +   +   +   +   +   + +     +   ++
+++++ +++ + +++++ +++ + +++++ + + +++++ +++++ +++ ++
+   +     + +     +   +     + + +       +   +   + ++
+ +++++++ + + +++++ +++ + +++ + +++ +++++ + +++ + ++
+   +     + +     + + + +     + +   + +   +   + + ++
+ + + +++++ +++++ + + + +++++++++ +++ + +++ +++ + ++
+ +       +         +             +       +       ++
++++++++++++++++++++++++++++++++++++++++++++++++++++
++++++++++++++++++++++++++++++++++++++++++++++++++++