++++++++++++++++++++++++++++++++++++++++++++++++++++
++         +           +   +               +       +
++ +++++++++ +++++++ +++ + + +++++++++++ + + +++ + +
++           +     +     + +       +   + +     + + +
++ +++++++++++ + +++++++++ +++ +++++ + +++++++++ + +
++ + +         +     +   +     +     + +     +   + +
++ + + +++++++++++ + + +++++++++ +++++ + +++ + +++ +
++ +   +   +       + +         +   +   + + +   +   +
++ + +++ + + +++++++ +++++ +++++++ +++ + + +++++ +++
++ + +   + +       + +   +       +   +   +   + + + +
++ + + +++ +++++++ + + + +++ + + +++ +++++ + + + + +
++ + +   +       + +   +   + + +   + +     +   +   +
++ + +++ +++++++ + +++++++ +++ + +++ + +++ +++ +++ +
++ +   + +   +   + +     +     + +   +   + +     + +
++ +++ + + + + +++ + +++ +++++++++ +++++++ +++++++ +
++ +   + + + + +   +   + +         +     + +     + +
++ + +++ + + + + + +++ + + +++++++++ + + + + +++ + +
++ + +   + + + + + +   +   +     +   + +   + + +   +
++ +++ +++++ + + +++ +++++++ +++ +++++ +++++ + +++++
++     +     + + +   +     + + +     +       +     +
++++++++ +++ + + + ++e +++ + + +++++ + +++++++++++ +
++       +   + + +   +   + +   + +   +   +     +   +
++++ + +++++++ + +++ +++ + +++ + + +++++ +++ + + + +
++   + +     +   + +   + +   + + +     + +   +   + +
++ +++++ +++ +++ + +++ + + +++ + +++++ + + +++++++ +
++ +   + + +     +   +   +     +     + +   +s  +   +
++ + + + + +++++++++ +++++++++++++++ + + +++++ + +++
++ + +   +         +   +     +     + + + +   + +   +
++ + +++++++ +++++ + + + +++ +++ + + + +++ + + +++ +
++           +       +   +       +   +     +   +   +
++++++++++++++++++++++++++++++++++++++++++++++++++++
++++++++++++++++++++++++++++++++++++++++++++++++++++