++++++++++++++++++++++++++++++++++++++++++++++++++++
++++++++++++++++++++++++++++++++++++++++++++++++++++
++         +     +       +     +       + +s    +   +
++ + +++++ +++ + + +++ + +++ + +++ +++ + +++++ + + +
++ +   + +     + +   + +     +     + + +   +   + + +
++ +++ + +++++++ +++++ +++++++++++++ + + + + +++++ +
++   + +       +     +   +   +   +   + + + +       +
++ +++ +++++ +++++++ + + + + + + + + + + +++++++++ +
++ +   +   +       + + +   +   + + + +   +         +
++++ + + + +++++++ + +++++++++++ + + + +++ +++++++++
++   + + +   +   +               + + + + e +       +
++ +++++ +++ + + +++++++++++++++++ + + + +++ + +++ +
++ +     +   + +     +             + + +   + +   + +
++ + +++++ +++ +++++ +++++++ +++++ +++ +++ + +++ + +
++ + +   +   + +   +       + +   +     +   +   + + +
++ + + + +++ + + + +++++++ + + + +++++++ +++++ + +++
++ +   +   +   + + +     + +   +       +   +   +   +
++ +++++++ +++++ +++ +++ + +++++++++ +++++ +++++++ +
++       + +   +   +   +   +   +   + +   +         +
++ +++ +++ + +++ + +++ +++++ + + +++ + + +++++++++ +
++   +     +   + +   +       + +     + + +   +     +
++++ +++++++++ + +++ +++++++++ + +++++ + + + + +++++
++ + +       +     +     +   + +   +   +   +   +   +
++ + + + +++ + +++++++ +++ + + + +++ +++++++++++ + +
++   + + + + + +     + +   +   + +   +     +     + +
++ +++++ + + +++ +++ + + +++ +++++ +++++ + + +++ + +
++ +     + +     +   + + +   +     +     + +   + + +
++ + + +++ +++++++ +++ + +++ + +++++ +++++ +++++ + +
++ + +   + +     +   + +   + + +   + +   + +     + +
++ +++++ + + +++ +++ + +++ +++ + + + + + + + +++++ +
++       +     +         +       +   + +     +     +
++++++++++++++++++++++++++++++++++++++++++++++++++++