++++++++++++++++++++++++++++++++++++++++++++++++++++
++++++++++++++++++++++++++++++++++++++++++++++++++++
+ +   +           +             +     + +   +     ++
+ + + + +++++++ + +++++++ +++++ + +++ + + + + +++ ++
+   + +       + +     +   +       + + +   +     + ++
+ +++ +++++++ + +++++ + +++ +++++++ + +++++++++++ ++
+ +     +   + +     +   + + +   +               + ++
+ + +++ +++ + +++++ +++++ + + + + +++++++++++++ + ++
+ + + +     + +   + +   +   + + +   +       + +   ++
+ + + + +++++ + + + + + +++++ + +++ + +++++ + +++ ++
+ + +   +       + +   + +     +   + +   +   +   + ++
+++ +++++ +++++++++++++ + +++++ + +++++ + +++ +++ ++
+   +   + e   +       +   +   + +       +   +     ++
+ +++ + + +++ + +++++ +++++ + + +++++++++++ ++++++++
+ +   +       +   +   +     + + + +       +       ++
+ + +++++++++++++ + +++ +++++ + + + +++++ + +++++ ++
+         +       + +   +   + + + +     + + +     ++
+ +++++++++ +++++++ +++ +++ + + + +++++ + + + +++ ++
+ +         +     +     +   + + + +   + + + +   + ++
+++ + +++++++ +++ +++++++ +++ + + + + + + + +++ + ++
+   + +     +   +   +       + +   + + + + + +   + ++
+ +++++ +++ +++ +++ + +++++ + +++++ + + + +++ +++ ++
+         +   + +   + +   + +       + + +     +   ++
+++++++++++ +++ + +++ + + + +++++++++ + +++++++ ++++
+         + +   + +     + +       +   +   +   +   ++
+ +++++++ + + +++ +++++++++++ +++++ +++ + +++ +++ ++
+       +   +   + +        s+     +   + +   + +   ++
+ +++++ +++ +++ + + +++++++++ +++ +++ +++++ + + ++++
+     +   + +   + +     + +   + +   + +     +   + ++
+++++ +++ +++ +++ +++++ + + +++ +++ + + +++++ +++ ++
+       +       +       +         +     +         ++
++++++++++++++++++++++++++++++++++++++++++++++++++++