++++++++++++++++++++++++++++++++++++++++++++++++++++
+       +   +       +           +                 ++
+ +++++++ + + +++++ + +++ + +++++ + + ++++++++++++++
+   +     +   +   + +   + + +   + + + +           ++
+ + + +++++++++ +++ +++ + + + + + + +++ +++++++ + ++
+ +   +       +   +     + + + +   +     + +   + + ++
+ +++++ +++ + +++ +++++++ + + +++++++++++ + + +++ ++
+ +     +   +           + + +     +       + +     ++
+ +++++++ +++++++++++++ + +++++++ +++++ +++ +++++ ++
+       + +         + + +   +   + +     +   +   + ++
+++++++ + +++ + +++ + + +++ + + + + + +++ +++ +++ ++
+     + +   + +   +   + + + + +     + +   +       ++
+++ +++ + + + +++ +++++ + + + +++++++++ +++++++ ++++
+   +   + + +   + +    e+ +   +   +     +     + + ++
+ + + +++++ +++++ + +++++ +++++ + + +++ + +++ + + ++
+ + +     + +     + +       +   + + + + + + + +   ++
+ +++++++ + + +++++ +++++ + + +++ + + + + + + +++ ++
+ +     +   +   +   +     + + +   + +   + + +   + ++
+ + + +++++++ + + +++ +++++ + +++ + +++++ + +++ + ++
+   + +     + +   +   +   + +   + + +       +   + ++
+ +++ + +++ + +++++ + + +++ + + +++ + +++++++ +++ ++
+   +     + + + +   + + +   + +   + + +   +   + + ++
+++ +++++++ + + + +++ + + +++++ + + + + +++ +++ + ++
+   +   +   + + + +   +   +   + + + + + +   +     ++
+ +++ + + +++ + + + +++ +++ + + + + + + + +++ ++++++
+ +   + +     +   + + + +   + + + +   + + +     + ++
+ +++++ +++++++++++ + + + +++ + + +++++ + +++++ + ++
+       +         + +   + + + + +       +     +   ++
+++++++ + +++++++ + + +++ + + +++++ +++ +++++ +++ ++
+         +         +     +         +       +  s+ ++
++++++++++++++++++++++++++++++++++++++++++++++++++++
++++++++++++++++++++++++++++++++++++++++++++++++++++