++++++++++++++++++++++++++++++++++++++++++++++++++++
++   +     +     +       +             +         + +
++ + +++++ + + + + +++++ +++++ +++++++ + +++++++ + +
++ +     + + + +   +   + +   +   +   +   + +     + +
++ +++++ + + + +++++ + + + + +++ + +++++++ + +++++ +
++ +   + + + +   +   +   + +     +           +   + +
++ + +++ + + +++ +++++ +++ +++++++++++++++++ + + + +
++ +       +   + +   + +         +   +     + + +   +
++ +++++++++++ + + + + +++++++++ + + + +++ + + +++ +
++ +  e        +   + +   +   +   + +     + + +   + +
++ + +++++++++++++ + +++ + + + +++ +++++++ + +++ + +
++ +   +   +     + + +     +   +   + +   + +     + +
++ +++ +++ + +++ + + + +++++++ + +++ + + + +++++++ +
++ +   +   + +   + + + +     + +   + + + + + +     +
++ + +++ +++ +++ + + +++ +++ +++++ + + + + + + +++++
++ +   +   +   + + + +   + +       + + +   +     +s+
++ +++ +++ +++ + +++ + +++ +++++++++ + +++++++++++ +
++   +   +   + +     + + +         + +   +   +     +
++ + +++ + +++ +++++++ + + + +++++ + +++ + + + +++++
++ + +   +   +   +   + + + +   +     +   + +   +   +
++ + + +++++ +++ + + + + + +++ +++++ + +++ +++++ +++
++ + + +       +   +   + + + +     + +     +       +
++ +++ + + +++++++++++++ + + +++++ + +++++++++++++ +
++ +   + +       +       + + +     + +           + +
++ + +++++++++ + +++ +++++ + + +++++ + +++++++++ + +
++   +       + +   + +       +   + + +       +     +
++ +++ + +++ + +++ + + +++++++++ + + + +++++ +++++ +
++ +   +   + + +   +   +   +     + + + +   +     + +
++ +++++++ + + + +++++++ + + +++++ + +++ + +++++ + +
++         +   +         +   +           +       + +
++++++++++++++++++++++++++++++++++++++++++++++++++++
++++++++++++++++++++++++++++++++++++++++++++++++++++