++++++++++++++++++++++++++++++++++++++++++++++++++++
++         +                 +     +     +         +
++ +++++++ + +++++ + +++++++ +++ + +++ +++ +++++ + +
++       +   +     + +     +     +   +     +   + + +
++++++++ +++++ +++++ + +++ +++++++++ + +++++ + + + +
++       +   + +   + + +   +   +     + +   + +   + +
++ +++++++ + + + + +++ + +++ + + +++++ + + + +++++ +
++ +   +   + +   + +   +   + + + + +   + +   +   + +
++ + +++ + +++++++ + +++++ + +++ + + +++ +++++++ + +
++ + +   +     +   +   +   +     + +   +       + + +
++ + + +++++++ + +++++ + +++ +++++ + +++++ +++ + + +
++ +     +   + +   +   +   +   +     +   + +   +   +
++ +++++ +++ + +++ + +++++ +++ +++ +++ + +++ +++ +e+
++   + +     +   +   +   +   +   + +   +     + +   +
++++ + +++++ +++ +++++ + +++ +++ + + +++++++++ +++ +
++   +     + +         + +   +   + + +   + +     + +
++ +++ +++++ + +++ +++++++ +++ +++ + + + + + +++ + +
++   +       +   + +       +   + + +   + + +   +   +
++++ +++ +++++++ + + +++++++ +++ + +++++ + +++ +++++
++ +   +   +     + + + +   +   +       + +       + +
++ +++ +++++ +++++++ + + + +++ +++++++++ +++++++ + +
++     +     +   +   +   +   +       +   +s  + +   +
++ +++++ +++++ + + + +++++++ +++++++ + + +++ + +++ +
++ +         + + + + +     +     +     + +   +     +
++ + +++++++ + + + + + +++ + +++++ +++++++ +++ +++++
++ + +       + +   + + + + +   +   +     +   +     +
++ +++ +++++ + +++++++ + + +++ + +++ +++ +++ +++++ +
++     + +   +       +   +   +     + +     +   +   +
++++++++ + +++++++++ +++ +++ +++++++ + +++++++ + +++
++                 +       +         +         +   +
++++++++++++++++++++++++++++++++++++++++++++++++++++
++++++++++++++++++++++++++++++++++++++++++++++++++++