++++++++++++++++++++++++++++++++++++++++++++++++++++
++ +         +         +         +                 +
++ + +++++ + + +++++++ +++ +++++ +++ +++++++++++++ +
++ + +   + +   +     +     +   +     +   +s+   +   +
++ + +++ + +++++ +++ +++++++ +++ +++++ + + + +++ +++
++ +   + + +   +   + +       +   +   + + + +     + +
++ +++ + + + + +++ + +++++ + + +++ + + + + + +++++ +
++ +     + + +   + +     + +   +   + + + + +       +
++ + +++++ + +++ + +++++ +++++++ +++ + + + +++++++++
++ + + +   +   + +     + +     + + + + + +         +
++ + + + +++++ + +++ +++ + +++ + + + + + +++++++++ +
++     +     + +     +   + + + +   +   +       + + +
++++++++++ + + +++++++ +++ + + +++ +++++ +++++ + + +
++       + + +   + +   +     +   +     +     + + + +
++ +++++ +++ +++ + + +++ +++++++ +++++ +++++ + + + +
++     +   + +   + +     + +         +     + +   + +
++ +++ +++ + + +++ +++++++ + +++ +++++++ +++ + +++ +
++   + + +   +   +         +   + +       +   + +   +
++ +++ + +++ +++ +++++++ + +++ + + +++++++ +++ + +++
++ +   +       +       + + e   + + +     +   + + + +
++ + +++++++++++++++++ + +++ +++++ + + + +++ +++ + +
++ +             +     +   +     + + + + + +     + +
++ +++++++++++ +++ +++++++ +++++ + +++ + + +++++++ +
++ +         +   + +         +   +     + +     +   +
++ + +++++++ +++ + + +++++++ + + +++++++ + +++++ + +
++   +     +   + + +     +   + +   +     +       + +
++++++ + +++++ + + +++++ + +++ +++++ +++++++++++++ +
++   + +     + +   +     + + +       +     +     + +
++ +++ +++++ + +++++ +++++ + +++++++++++ + + +++ + +
++         +         +                   +   +     +
++++++++++++++++++++++++++++++++++++++++++++++++++++
++++++++++++++++++++++++++++++++++++++++++++++++++++