++++++++++++++++++++++++++++++++++++++++++++++++++++
+         e +   +     +   +     +   +   +         ++
+++++++++ + + + + + + + + + +++ + + +++ + +++++ + ++
+       + +   + + + + + +   +   + +     +   +   + ++
+ +++++ +++++++ + + + + +++++ +++ +++++++ +++ +++ ++
+ +   +   +     + + +   +   +     +     + +   + + ++
+ + + +++ + +++++ + +++++ +++ +++++ +++ + + +++ + ++
+ + + +     +     + +         +   +   +   + +     ++
+ +++ + +++++ +++++ +++++++++++ + +++ +++++ + ++++++
+   +     +   +     +     +   + +     +     + +   ++
+ + + +++++ +++ +++ + +++ + + + +++++++ +++++++ + ++
+ + + +     + +   + +   + + +   +     +         + ++
+ + +++ +++++ +++ +++ +++ + +++++ +++ +++++++++++ ++
+ +     +     + +     +   +       +             + ++
+ +++++++ +++ + +++++++ +++++ +++++++++++++++++ + ++
+     +   + +     +   +     + +             +   + ++
+++++ + +++ +++++ + +++++++ + + +++++++++++ +++++ ++
+ +   + +       + +   +   +   +   +       +       ++
+ + +++ +++++++ + + + + + +++++++ + ++++++++++++++++
+ +   +   +     + + +   +       + +               ++
+ +++ +++ + +++ + +++++++++++ + + +++ +++++++++ + ++
+   + +   + +   +   +       + + +   +   +     + + ++
+++ + + +++ +++++++ + +++++ + + +++ +++++ +++ + ++++
+   +   +           + +     + +   +       + + +   ++
+ +++++++ +++++++++++ +++ +++++++ +++++++++ + +++ ++
+       +   +       +   + +     +         + +  s+ ++
+ + +++++++ +++ +++ + + + +++ + +++ + +++ + +++++ ++
+ +   +   +     + + + + +     +   + + + + +       ++
+ +++ + + +++++++ + +++ +++++++++ +++ + + +++++++ ++
+   +   +               +             +           ++
++++++++++++++++++++++++++++++++++++++++++++++++++++
++++++++++++++++++++++++++++++++++++++++++++++++++++