++++++++++++++++++++++++++++++++++++++++++++++++++++
++++++++++++++++++++++++++++++++++++e+++++++++++++++
++       +   +   +           +   +           +     +
++ +++ + + + + + +++++++ +++ + + + +++++ +++++ +++ +
++   + +   +   +       + + +   + +   + +   +   + +s+
++++++ +++++++++++++++ + + +++++ +++ + +++ + +++ +++
++     +   +           +       +   +   +   + +     +
++ +++++ +++ +++++++++++++++++++++ +++ + +++ + +++ +
++     +   +     +               +     + +   +   + +
++ +++ +++ +++++ +++++ +++++++++ + +++++ + +++ + +++
++ + +   +     + +     +       + + +     + +   +   +
++ + +++ +++ + + + +++++++++++ + + + +++ + + +++++ +
++ +   +   + +   +   +         + + + +   + +     + +
++ +++ +++ + +++++++ + +++++++++ +++ + +++ +++++++ +
++   + +   +   +     + +         +   +   +   +     +
++++ + + +++++ +++ +++ + +++++++++ + +++++++ + +++ +
++ +   +   +     + +     +         + +     +   +   +
++ +++ +++ +++++ + + +++++++ + + +++++ +++ +++++ +++
++       +     + + + +     + + + +     + +   +   + +
++++++++++++++ + + + + +++ +++ + + +++++ +++ + +++ +
++           + +   + + +       + +   +     +   +   +
++ +++++++++ + +++++ + +++++++ +++++ +++++ +++++ + +
++ +   +       +   + +     +   +   +         +   + +
++ + + +++++++++ + + +++++ + +++ + +++++++++ + +++ +
++   + +   +     +       + +   + +         + +   + +
++ +++ + + +++++++++++++ + + +++ +++++++++ + + + +++
++ +   + +       +     +   + +   +       + + + +   +
++ + + + +++++++ + +++ + +++++ +++ +++++++ + +++++ +
++ + + + +   + +   +   + +   +   +     +   +       +
++ + +++ + + + +++++ +++++ + +++ +++++ + +++++++++ +
++ +       +       +       +           +           +
++++++++++++++++++++++++++++++++++++++++++++++++++++