++++++++++++++++++++++++++++++++++++++++++++++++++++
++                     +             +         +   +
++ +++++++ + +++ +++++++ +++++++++++ +++++++ + +++ +
++   +   + + + + +   +   + +       + +       + +   +
++++ + + +++ + + + + + +++ + + +++++ + +++++++ + +++
++   + + +   +   + +   + +   +   +   +   +   + +   +
++++++ + + +++++++ +++++ + +++++ + +++++ +++ + + + +
++     + + +s+     +   +   +     +       +   + + + +
++ +++++ + + + +++++ + + +++ +++ +++++++++ + + + + +
++     +   +   +     + + +   + +     +     + + + + +
++++++ +++++++++ +++ + +++ +++ +++++ + +++++ + +++ +
++   +             + +   + +       + +   +   +   + +
++ + +++ +++++++++++ +++ + +++ + +++ +++ +++++++ + +
++ +   +       +   + +   +   + + +   +   +       + +
++ +++ + +++++++ + + +++ +++ +++ + +++ + + +++++++ +
++ +   + +       + +   +     +   +   + + + +   +   +
++ +++ + + +++++++ + + +++++++ +++++ + + + + + +++ +
++   + + +     +   + +       +   +   + + +   +     +
++ + + + +++++ + +++ +++++++ + + + +++ + +++++++++ +
++ + + + +     +   +       + + +   +   + +       + +
++ + + +++ +++++++ +++ +++++ + +++++++ +++ + +++++ +
++ + + +   + +   + +   +     +       +     + +     +
++++ + + +++ + + + +++++ +++ +++++++ +++++++ + +++++
++   +   +     + + +     +   +   +           + +   +
++ +++++++++++++ + + +++ +++++ + +++++++++++ + + + +
++ +     +     +     +   +     + +         + +   + +
++ + +++ + +++ +++++++++++ +++++ + +++++++ +++++++ +
++   + + +   +           + + +   + +     + +       +
++ +++ + +++ +++++++++++ + + + +++ +++++ + + +++++++
++     +               +     +           +         +
+++++++++++++++++++++++++++++++++++++++++++++e++++++
++++++++++++++++++++++++++++++++++++++++++++++++++++