++++++++++++++++++++++++++++++++++++++++++++++++++++
++           +           +               +         +
++ +++ +++++ +++++++++ + + +++ +++++++++ + +++++++++
++ +   +   +     +   + + + +   +       + +     e   +
++ + + + + +++++ + + + + +++ +++ + +++++ + +++++++ +
++ + + + +     +   +   +   +   + +       +       + +
++ + +++ +++++ +++++++++++ + + + +++++++++++ +++++ +
++ +   +   +   +     +     + + +           + +     +
++++++ +++ + +++++ + + +++++ + +++++++++++ +++ +++ +
++   +     + +   + + +   +   + +       + +     + + +
++ + + +++++ + + + + +++ +++ + + +++++ + +++++++ + +
++ + + +   +   + + +   +   + +     +   +         + +
++ + + +++ +++++ + +++ +++ +++++++++ +++++ +++++++ +
++ + +     +     + + +   + +   +   + +     +   +   +
++ + +++++++ +++++ + +++ + + + + + + + + +++ + + +++
++ +   +     +   +     +     +   +   + +     +   + +
++ +++ + +++++ +++++++ +++++++++ +++++ +++++++++++ +
++ +   + +   +     +   +     +   +   + +         + +
++ + +++ + + +++++ + +++ +++ +++++ + + +++ +++++ + +
++ +   +   + +     +   + + +       + + +   +   +   +
++ +++ +++++ + +++++ +++ + +++++ +++ + + +++ + +++ +
++   +     + +   +   +   + +  s+ +   + +   + + +   +
++ + +++++ + + + + +++ +++ + +++++ +++ +++ + + + +++
++ +     +   + +     +     +       + +     + + + + +
++ +++++ +++++++++++++++++ +++++++++ +++++++ +++ + +
++ +   +             +   + +       +           + + +
++ + +++++++++++++++ + + + + +++ +++ +++++++++ + + +
++ +       +     +   + + + + +   +   +       + +   +
++ +++++ + + +++ + +++ + + + + +++ +++++ +++ + +++ +
++       +   +   +     +   + +           +   +     +
++++++++++++++++++++++++++++++++++++++++++++++++++++
++++++++++++++++++++++++++++++++++++++++++++++++++++