++++++++++++++++++++++++++++++++++++++++++++++++++++
++++++++++++++++++++++++++++++++++++++++++++++++++++
++         e       +     +   +         +   +       +
++ + +++++ + +++++ + +++ + +++ +++ +++ + + + +++++ +
++ + +       +   +   + +   +   + + + +   + + + +   +
++ + +++++++++ +++++++ +++ + +++ + + +++++ + + + +++
++ + +     +               +     + +     + +   +   +
++++ + +++ + +++++++++++++++++++ + + + +++ + +++++ +
++   +   + +             +     + + + + +   + +     +
++ +++++ + + +++++++++++++ + +++ + + +++ +++++ +++++
++   +   + + +   +     +   +   + + +         +     +
++ + + +++ + + + + +++ + +++++ + + + +++++++ +++++ +
++ +   +   + + +   +   + +   + + + + +   + + +   + +
++ +++++ +++++ +++++ +++ + +++ + + +++ + + + + + + +
++     +     + +   +     +   + + +     + +   + +   +
++++++ +++++ + + +++++++++++ + + +++++++ + +++ +++ +
++ +   + +   + + +         + + +     + + +     +   +
++ + +++ + +++ + + +++ +++ + + +++++ + + +++++++++++
++ +   + +     +     + +   + +     +   +          s+
++ +++ + +++++++++++++ +++ + + +++ +++ +++++++++++++
++   +               +   +   +   +   +   +     +   +
++ +++++++++++++++++ + + +++ +++ +++++++ +++ + +++ +
++ +       +   +     + +   + +   +   +   +   +   + +
++ + + +++ + + + +++++++++ +++ +++ + + +++ +++++ + +
++   +   + + + +     +     +   +   + +     + +   + +
++ +++++ +++ + +++++ + +++++ +++ +++ +++++++ + +++ +
++ +   +     +     + + +   +   +   +         +   + +
++ + + +++++++++++ + + + + +++ +++ +++ +++++++++ + +
++   + +     +   + + +   +   +   +   +         +   +
++++++ +++ + +++ + + +++++++ +++ +++ +++++++ +++++ +
++         +     +             +           +       +
++++++++++++++++++++++++++++++++++++++++++++++++++++