++++++++++++++++++++++++++++++++++++++++++++++++++++
+       +               +   +   +           +     ++
+ +++ + +++++++ + +++++ +++ + + + + +++++++ + +++ ++
+   + +   +     + +   +     + + + + +   +   + +   ++
+ +++ +++ + +++ +++ + +++++ + + + + + +++ +++ + ++++
+ +   +   + + + +   +   +   + +   + +   + +   +   ++
+ + +++++ + + + + +++++ +++++ +++++ + + + +++++++ ++
+ +     + + +   + +   + +   +   + + + +   +     + ++
+++++++ + + +++++ + + + + + +++ + + +++++ + +++ + ++
+       + +   +   + + + + +   +   +     +   + + + ++
+ +++++++ +++ + +++ +++ + + +++++ +++++ +++++ + + e+
+ +     +   +   + +   +   +       +   + +   +   + ++
+ +++++ +++ +++ + + + +++++++++ +++ + + +++ + +++ ++
+ +   +       + +   +   + +   +     + +   +     + ++
+ + + +++++++ + + +++ + + + + +++++++ +++ +++++ + ++
+ + +       + + +   + +   + + +   +     +   + + + ++
+ + +++++++ + + +++++ +++++ + + + +++++++++ + + + ++
+ + + +s    + +       +     +   +           + + + ++
+ + + +++++++ +++++++++ +++++++++++++++++++++ + + ++
+ + +       +     +   +     + +               +   ++
+ + +++++ + +++++ + + +++++ + + +++++++++++ + +++ ++
+   +   + + +   + + + +     + + +       + + + +   ++
+++++ + + + + +++ + + + +++++ + + +++++ + + + + ++++
+     +   + +   +   +   +   +   +     + + + + + + ++
+ + +++++++ +++ +++++++++ + + +++++++ + + + + + + ++
+ +   +   + +         +   + + +       + + + + + + ++
+ +++ + + + + +++++++++ +++ + + + +++++ + + +++ + ++
+   +   + +   +         + +   + + +   +   +   +   ++
+++ +++++ +++++ +++++++++ +++++++ + + +++ +++ +++ ++
+       +                         + +       +     ++
++++++++++++++++++++++++++++++++++++++++++++++++++++
++++++++++++++++++++++++++++++++++++++++++++++++++++