++++++++++++++++++++++++++++++++++++++++++++++++++++
++++++++++++++++++++++++++++++++++++++++++++++++++++
+     + +   +                       +         +   ++
+ +++ + + + + +++++++++++ +++++++++ + +++++++ +++ ++
+ + + +   +   +   +       +       +   +   +       ++
+ + + +++++++++ + + +++++ + +++++ +++++ +++ +++++ ++
+ +     +   +   +   + +   + +   + +   +     +   + ++
+ +++++ + + + +++++++ + +++ +++ + + + +++++ + + ++++
+ +   +   + +   +   +     +   + +   + +   + + +   ++
+ + + +++++ +++ + + +++++++++ + +++++ + + +++ +++ ++
+   + +   +     + +     +   +   +   +   +   +   + ++
+++++ + + +++++++ +++++ + + +++ +++ +++++++ +++ + ++
+   + + +         +   +   +   +           + +   + ++
+ + + + +++++++++++++ +++++ +++++++++++++ + + +++ ++
+ +   + +       +         +       +       +   +   ++
+ +++++ + + +++ + + +++++++++++++ + +++++++++++ ++++
+     + + +   + + +             +   + +       +   ++
+ +++ + + +++ + + +++++++ +++++++++++ + +++ + +++ ++
+ +   + + + + + +   +   +   +           +   + +   ++
+++ + + + + + +++++ +++ +++ + +++++++ +++ +++ + ++++
+   + + + + +           + +   +     + +   + + +   ++
+ +++ + + + +++++++++++ + +++++ +++ +++ +++ + +++ ++
+ +   + +     +     + + +     +   + +   +s+ + +   ++
+ + +++ +++++ + +++ + + +++++ ++e + + + + + + + + ++
+ + +   + +   + + + +           + +   + + +   + + ++
+ +++ +++ + +++ + + +++++++++++ + +++++ + +++++ + ++
+     +     +   + + +     +     +     + +     + + ++
+ +++++++ +++ +++ + + +++ +++++ +++++ + +++++ + + ++
+   +   + +   +   +   + +     +     + + +     + + ++
+++ + + +++ +++ + +++++ +++++ +++++++ + + +++++ + ++
+     +     +   +                     + +       + ++
++++++++++++++++++++++++++++++++++++++++++++++++++++