++++++++++++++++++++++++++++++++++++++++++++++++++++
++   +         +                 +         +     + +
++ + + +++++++ + +++++++++++++++ + +++++++ + +++ + +
++ + +   +     + + +     +   +   +   +   +   + +   +
++ + + +++ +++ + + + + + + + + + +++ +++ +++++ +++ +
++ +   +   +   + +   + +   + + +   + +   +       + +
++ +++++ +++ +++ +++++ +++++ + +++++ + +++ +++++ + +
++ +     + + + + +     +   + +     + +   +   + +   +
++ + +++++ + + + + +++ + + + +++++ + + + +++ + +++++
++ +   +   + + +   +   + + +   +   + + +   +     + +
++ +++ + + + + +++++ +++ + +++ + + + + + + +++++ + +
++ +   + +   +   +   +   + +   + + + + + + +   + + +
++ + +++++++ +++ + +++ +++ +++++ +++ +++ + e + + + +
++ + +     +     + + +   +     +   + +   + + +   + +
++ + + +++ +++++++ + +++ +++++ + + + + +++++ +++++ +
++ + + + +     +   + +   +   + + + + +   +   + +   +
++++ + + +++++ + +++ + +++++ + +++ + + + + +++ + + +
++   +   +   +   +   + +   +       + + + + +     + +
++ + +++ + + +++++++ + + + +++ +++++ + + + +++++++ +
++ +   +   +         + + +   + +     + + +     +   +
++ +++ +++++ +++++ +++ + +++ +++ +++++ + +++++ + + +
++ + + +     +   + +   + +       +   + +     + + + +
++ + + + +++++ + +++ + + + +++++++ + + +++ +++ + + +
++ +   + + +   +     + + +   +   + + + + +     + + +
++ +++++ + + +++ +++++++ +++++ + + +++ + +++++++ + +
++ +     + +   + +     +       +s+     +   +     + +
++ + +++++ +++ +++ +++ +++++++++++ +++++ + + + +++ +
++ + +     + +     +   +   +     +   +   +   +   + +
++ + + +++ + +++++++ +++ + + + +++++ +++++++++++ + +
++     +           +     +   +                   + +
++++++++++++++++++++++++++++++++++++++++++++++++++++
++++++++++++++++++++++++++++++++++++++++++++++++++++