++++++++++++++++++++++++++++++++++++++++++++++++++++
++ +       +       +       +                   +   +
++ + +++++ + +++ +++ + +++ +++ +++++++++++++++ + + +
++   +   +   + +   + + +     +         +   +     + +
++ +++++ +++++ +++ + + +++++ +++++++++ + + +++++++ +
++   +     +     +   +     +           + + +     + +
++++ + +++ + +++ +++++++ + +++++++ +++++ + + +++ + +
++ + +   + + +     +   + +     + + +     + +   + + +
++ + +++ + +++ +++ + + +++ +++ + + + +++++ +++ + + +
++ + +   +     +   + +   + +   +   +   + +     + + +
++ + + +++++++++ +++ +++ +++ +++ +++++ + +++++++ + +
++ +   +       +   + + +     + + +   +         + + +
++ + +++++++++ +++ + + +++++++ + +++ +++++++ +++ + +
++   +       +     + +         +       +     +   + +
++ +++ +++++ + +++++ +++++ +++++++++ +++ +++++ +++++
++ + + +     +   + +     + +         +   +   +     +
++ + + + +++++++ + +++++ + + +++++ +++ +++ + +++++ +
++ + + +   +   + +     + +   +   + +       +     + +
++ + + +++ +++ + +++ + + +++++ + +++ +++++++++++ + +
++ + + +     +       + + +     +   + +   +   +   + +
++ + + +++++ +++++++++++ + +++++ + + + + + + +++++ +
++   +     +         +   + +  s+ +   + +   +       +
++++ +++++ +++++++++ + +++ + +++ +++++ +++++++++++ +
++ +     +     +   +   +   + +   +  e+   +   +   + +
++ + +++++++++ + + +++++ +++ + +++ + + + + + + +++ +
++ + +       + + +         + + +   + + +   + +     +
++ + + +++++ + + +++++++++++ + + +++ +++++ + +++++++
++   + +       + +     +     + + +   +   + +       +
++ +++ +++++++++ +++++ + +++++++ + +++ + +++++++++ +
++   +                 +         +     +           +
++++++++++++++++++++++++++++++++++++++++++++++++++++
++++++++++++++++++++++++++++++++++++++++++++++++++++