++++++++++++++++++++++++++++++++++++++++++++++++++++
++     +     +     +             +     +       +   +
++++ + + + + +++ + + +++++ +++++ + +++ +++ + + + + +
++   + + + +     +   +     +   +   + +   + + +   + +
++ +++ + + +++++++++++ +++++ + +++++ +++ +++ +++++ +
++ + + + +       +       +   + +       +   + +     +
++ + + +++ +++++ + +++++++ +++ +++++ + +++ + +++ +++
++ +     +   +   +   +     + + +   + +   + +   + + +
++ +++++ +++++ +++++ + +++++ + + + + + +++ +++ + + +
++   +         +   + +   +   +   + + +         +   +
++ + +++++++++++ + + +++ + +++++++ + +++++++++++++ +
++ +     + +     +     + +       + +   +   +       +
++ +++++ + + +++++++++++ + +++ + + +++++ + +++++++ +
++   +   + + +       +   +   + + e     + +       + +
++++++ +++ + + +++ +++ +++++ + + +++++ + +++++++ +++
++     + +   + +   +   +   + + +     +   +     +   +
++ +++++ + +++ +++++ +++ + +++ + +++++++++ +++ +++ +
++ +   + +   + +     +   +     + +       + +       +
++ + + + +++ + + +++++ +++++++++++ +++++ + +++++++++
++ + + + +     +     +         +   +     +   +     +
++ + + + + +++++++++ +++++++++ + +++++ +++ + + +++ +
++   + +   +       + +   +   + +    s+   + +   +   +
++ +++ +++++ +++++ + + + + + + +++++++++ +++++++ +++
++   + +   + +   + + + +   +   +       +   +   +   +
++++ + + + + + +++ + + +++++++ +++++ +++++ + + +++ +
++   +   +     +   +   +   +   +   + +   + + +   + +
++ +++++++++++++ +++++++ + + +++ + + + + + + +++ + +
++ +     +       +     + + +     + + + +   + + + + +
++ + +++ + +++++++ + +++ + +++++++ + + +++++ + + + +
++   +   +         +     +           +       +     +
++++++++++++++++++++++++++++++++++++++++++++++++++++
++++++++++++++++++++++++++++++++++++++++++++++++++++