++++++++++++++++++++++++++++++++++++++++++++++++++++
+   +   +           +     +                       ++
+ + + +++ +++ +++++++ + + + ++++e +++++++++++++++ ++
+ +   +   +   +       + + +   +   +     +     +   ++
+ +++ + +++ +++ +++++++ + +++ + +++ +++ + +++ +++ ++
+   + +   +   + +       +   + + +   + +   + +   + ++
+ + +++++ +++ + + +++++++++ + +++ +++ +++++ +++ + ++
+ +     +   +   +   + +     +   +   +     + +   + ++
+ +++++ +++ +++++++ + + +++++++ +++ +++ + + + +++ ++
+ +   +   +       + + + +     +     +   +   +   + ++
+ + +++++ +++++++ + + + + + +++++++++ +++++++++ + ++
+ + +           + + +   + + +             +     + ++
+ + + +++++++++++ + +++++ + + +++++++++++ + +++++ ++
+   +             +   +   + +     +       +  s+   ++
+++ +++++++++++++++++ + +++ +++++ + +++++ +++++ ++++
+ +                 + +   +   +   + +   + + +   + ++
+ +++++++++++++++++ + +++ + +++ +++ + + + + + +++ ++
+ +           +   + +   + +     +   + + +   +   + ++
+ + +++++++ + +++ + +++ + +++++++ +++ + +++ +++ + ++
+ + +   +   +     + +   +       +   + + +     + + ++
+ + + + + +++++ +++ + + +++++++ +++ + + +++++++ + ++
+   + + + +     +   + +   +   + + + + +         + ++
+ +++++ + +++++++ +++ +++ + + + + + + +++++++++++ ++
+     + + +     + + + +   + +   + + + +   +     + ++
+++++ + + + +++ + + + +++++ +++++ + + + +++ + + + ++
+ +   + + +   + + + +     +     + +   +     + + + ++
+ + +++ + +++ + + + +++++ +++++ + +++++++++++ + + ++
+ +   + +   + + + +   +   +   +           +   +   ++
+ +++ + + +++ + + +++ + +++ + +++++++++++ + +++++ ++
+       +     +       +     +               +     ++
++++++++++++++++++++++++++++++++++++++++++++++++++++
++++++++++++++++++++++++++++++++++++++++++++++++++++