++++++++++++++++++++++++++++++++++++++++++++++++++++
++++++++++++++++++++++++++++++++++++++++++++++++++++
+             +                     +         +   ++
+ +++++++ +++++ +++++++++++++++++++ + +++++++ + ++++
+       +       +     + +         +   +     + +   ++
+++++++ +++++++++ +++ + + +++ +++ +++++ +++ + + + ++
+     +   +       +   +   +   + +   +   + + + + + ++
+ +++++++ + + +++++ +++++++ +++ +++ + +++ + + +++ ++
+ +       + + +   + +       + +   + +   + +   +   ++
+ + +++++++++ +++ + + +++++++ + + + +++ + +++++ + ++
+ +   +       +   + + + +   +   + + +   +       + ++
+ +++ +++++ +++ +++ + + + + + +++ + + +++ +++ +++ ++
+   + +   +   + +   + +   +   +   + + + + +   + + ++
+++ + + + + + + + +++ +++++++ + +++ + + + + +++ + ++
+   + + + + + + +     +     + +     + +   + +     ++
+ + + + + +++ + +++ +++ +++ +++++++++ +++++ + ++++++
+ + +   + +   +     +   + +     +     +     + +   ++
+ +++++++ + +++++++++ +++ +++++ + +++++ +++++ + + ++
+         +     +     +     +   +   +   +   +   + ++
+ +++++++++++ + + +++ +++++ + +++++ + +++++ +++++ ++
+ +         + + + +   +   + +   +   + +         + ++
+ +++++++ + +++ + +++++ + + +++ + +++ + + +++++++ ++
+         +   + +     + + +   +   +   + +     +   ++
+++++++++++++ + +++++ + + + +++++++++ + +++++ + ++++
+           + +   + +   + +         + + +     +   ++
+ +++++++ + + + + + +++++ +++++ +++ + + + + +++++ ++
+   +     + +   +     + +    s+ + + + + + + +     ++
+++++ +++++++++++++++ + +++++++ + + + + e +++ ++++++
+     +   +   +     + +   +   + + +   + +   +   + ++
+ +++++ + + + + +++ + + + + + + + +++++ +++ +++ + ++
+       +   +     +     +   +   +         +       ++
++++++++++++++++++++++++++++++++++++++++++++++++++++