++++++++++++++++++++++++++++++++++++++++++++++++++++
++             +             +     +             + +
++++++ +++++ + + + +++++++++ + + + +++++++++++ + + +
++  s+   +   + + + +     +   + + + +           + + +
++ +++++++ +++ + + + +++ + +++++ + + +++++++++++ + +
++       +   + + + +   + + +     +   +       + +   +
++++++++ +++ +++ + + + +++ + + +++++++ +++++ + +++ +
++     +   + +   + + +   + + +             + +   + +
++ + +++++ + + +++ +++++ + +++++++ +++++++++ + + + +
++ + +     + +   +     +   +     +   +   +   + + + +
++ + + +++++ +++ +++++ + +++ +++ + +++ + + +++ + + +
++ + + +       + +     + +   +   + +   + +   + +   +
++ + + +++++ +++ + +++++ + +++ +++++ +++ +++ + +++++
++ + +     + +   +   + + + +   +     + +     +     +
++++ +++++ + + +++++ + + + + +++ +++++ +++++++++++ +
++       + +     +   +     + +     +     +       + +
++ +++++ + +++++++ +++++++++ +++++ + + + + + +++++ +
++ +     +   +   +       + +       + + + + + +   + +
++ +++ +++++ + + + +++++ + +++++++++ + +++ + + + + +
++   + +   +   + + +     +       +   +     + + +   +
++ + + + +++++++ +++ +++++ +++++ + +++++ +++ + +++++
++ + + + +  e  + +   +       + + + +   + +   +     +
++++ + + + +++ + + +++ +++++ + + +++ + +++ + +++++ +
++   +   + +   +   + +   +   +       +     + +   + +
++ +++ +++ + + +++++ +++ + +++++++++++++ +++++ + + +
++ + + +   + +         + +       +   +   +     +   +
++ + + + +++ +++ +++++++ +++++++ + + +++++ +++++++++
++ +   + +   +   +     + +     +   + +   + +       +
++ +++++ + +++++++ +++ + +++ + +++++ + + + + +++++ +
++       +           +       +     +   +     +     +
++++++++++++++++++++++++++++++++++++++++++++++++++++
++++++++++++++++++++++++++++++++++++++++++++++++++++