++++++++++++++++++++++++++++++++++++++++++++++++++++
++     +     +     +             +   +         +   +
++ +++ + + +++ + +++ + +++++++++ + + + + +++++ + + +
++ +   + + +   +     +   +     +   + + + +   +   + +
++ + +++ + + +++++ +++++ +++ + +++++ + + + + +++++ +
++ +     +   +   + +   +   + +   +   + + + +     + +
++ +++++++++++ + +++ + +++ + +++ + +++++ + +++++ + +
++     +     + + +   +     + + +   +     + +   + + +
++++++ + +++++ + + +++++++++ + +++++ +++++ + +++ + +
++   +   +     + + +       +       +     + +   +   +
++ +++ +++ +++++ + +++ +++++++++++ +++++ + +++ +++++
++     +   +   + +   +                 + +         +
++ +++++ +++++ + +++ + +++++++++++++++ + +++++++++ +
++   +   +   +       + +       +   +     +         +
++++++ +++ + +++ +++++++ +++++ + + +++++++ +++++++++
++   + +   +   + +   +   +   + + +   +   + +   +   +
++ + + + +++++ +++ + + +++ +++ + +++ + + + + + +++ +
++ +   +     + +   +   +     +   + +   + + e + +   +
++ +++++ +++++ + +++++++ +++ +++++ +++++ +++++ + + +
++   +   +     + +         +   +       + +   +   + +
++ + + +++ +++++ +++++++ +++ +++ +++++ + + +++++++ +
++ +   + +       +     + +   +     +   + +   +   + +
++ +++++ +++++++++ +++ +++ +++ +++++ + + +++ + + + +
++ +                 +   +     +     + + +   + +   +
++ +++ +++++++++++++ +++ +++ +++ +++ +++ + + + +++++
++   +     +   +     + +   +   + +   +s+ + + +     +
++++ +++++++ + + +++++ +++ +++++ + +++ + + + +++++ +
++ + +     + + +   +       +     + +   + + + +     +
++ + + +++ + + +++ + +++++++ +++++ + +++ + +++ +++++
++     +     +     +         +     +     +         +
++++++++++++++++++++++++++++++++++++++++++++++++++++
++++++++++++++++++++++++++++++++++++++++++++++++++++