++++++++++++++++++++++++++++++++++++++++++++++++++++
+                 +   +         + +   + +         ++
+ +++++++++++ +++ + + +++ +++ + + + + + + +++ +++ ++
+ +   +       + + + +   + + + +   + + + + + +   + ++
+ + + + + +++++ + + +++ + + + +++++ + + + + +++ + ++
+   + + + +   +     + + +   +   +   + +     +   + ++
+++++ + +++ + +++++++ + +++++++ + +++ +++++ + ++++++
+ +   + +   +   +   + +     +   +   +     + +     ++
+ + +++ + +++++ + + + +++++ + +++++ +++++ +++++++ ++
+ +   +   +   + + + +     + +     +s+   + +       ++
+ +++ +++++++ + + + + +++++ + + +++++ + + + +++++ ++
+     +       +   + +     + + +     + + + + +     ++
+ +++++++ +++ +++++ + +++ + +++++ + + +++ + +++++ ++
+ +     +   + +   + + + + +       +   +   +     + ++
+ + +++ +++ + + + + + + + +++ +++++++++ +++ +++ ++++
+ +   +     + + +   +   +     +         + + + +   ++
+ +++e+++++++ + +++++++ +++++++ +++++++++ + + +++ ++
+   +     +   +   +           +   +       +     + ++
+++ +++++ +++++++ + +++++++++ +++ +++ +++++ +++++ ++
+   +   +   +     + +     +     +   + +     +     ++
+ +++ + +++ + +++++++ +++ +++++ +++ + + +++++ +++ ++
+     +   + + +   +   + +   +     + +       + +   ++
+++++++++ + + + + + +++ +++ +++++++ +++++++ + ++++++
+       +   +   + +     + +   +   +   +   + +     ++
+ +++++ +++ +++++ +++++ + +++ + + +++ + + + +++++ ++
+ +   +   +     + +   + +   +   + +   + +   +     ++
+ + + + +++++ +++ + + + +++ +++++ + +++++++++ +++ ++
+ + +   +   + +   + + +   + +     +   +       +   ++
+ + +++++ + + + +++ + +++ + + +++++++ + +++++++ ++++
+ +       +   +     +       +           +         ++
++++++++++++++++++++++++++++++++++++++++++++++++++++
++++++++++++++++++++++++++++++++++++++++++++++++++++