++++++++++++++++++++++++++++++++++++++++++++++++++++
++++++++++++++++++++++++++++++++++++++++++++++++++++
++   +           +   +       +               +     +
++ + + +++++ +++ +++ + +++ +++ +++ +++++++++++ + + +
++ + +   + + + +     + + +   +   +     +       + + +
++++ +++ + + + +++++ + + +++ +++ +++++ + +++++++ + +
++     +   + +       + +   +   +   + +   +   +   + +
++ +++++++ + + +++++++ +++ +++ +++ + +++++ + + +++ +
++ +       + + + +     +     +   +   +     + + +   +
++ + +++++++ + + + +++++ +++++ +++ +++ +++++ + + +++
++         + +   +   +       + +   +   +s+   + +   +
++ +++++++++ +++++++ + +++++ + + +++ +++ + +++ +++ +
++ +         +       +   +   +   +   +   + +   +   +
++ + +++++++++ +++++++++++ + +++++ +++ +++ + +++++++
++ +       +   +           +     + +   +   + +     +
++ +++++++ + +++++ +++++++++++ +++ + +++ +++ + +++ +
++ +     + + +    e+     + +   +   + +   +       + +
++ + +++++ + +++ +++++ + + + +++ +++ + +++++++++++ +
++ +     +   +   +     + + +   +   +   +     +   + +
++ +++ + +++++ +++ +++++ + +++ +++ +++++++ + + + + +
++   + + +     +   +         +   +       + + + + + +
++++ +++ + +++ + +++ +++++++++ +++++++++ + + + + + +
++ +   +   +   + +   +         +     +   + +   +   +
++ +++ + +++ +++ +++++ +++++++++ +++ + +++ +++++++ +
++   + + + +   +     + +     +   + +   +     +     +
++ +++ + + +++ + +++ + + +++ + +++ +++++++ + + +++++
++ +   +   +   + + + +   + + +     +     + + + +   +
++ + +++++ + +++ + + +++++ + +++++ + +++ +++ + + + +
++ +   +   +   +   + +   +   +   + +   +     +   + +
++ +++ +++++++ +++ + + + + +++++ + +++ +++++++++++ +
++             +   +   +         +     +           +
++++++++++++++++++++++++++++++++++++++++++++++++++++