++++++++++++++++++++++++++++++++++++++++++++++++++++
++++++++++++++++++++++++++++++++++++++++++++++++++++
+   +         +         +               +     +   ++
+ + + +++++++ + + +++++ + +++++++++ +++++ + + + + ++
+ +   +     + + + +     + +       +       + +   + ++
+ +++++ +++ + +++ + +++++ + +++++ +++++++++ +++++ ++
+ +       + +     + +   + + +   +     + +   +   + ++
+ +++ +++ +++++++++ +++ + + + +++++ + + + +++ + + ++
+   +   +         +   + + + +     + +   +   + +   ++
+++ +++++ +++ +++++++ + + + +++++ + +++ +++ ++++++++
+   +   +   +           + + +     + +     +   +   ++
+ + + + +++++++++++++++++ + + +++++ +++++++++ + + ++
+ + + + +           +     +   +     +       + + + ++
+ +++ + + +++++++++ + +++++++ + +++++ +++ + + + + ++
+ +   +   +       +   +       +       +   + +   + ++
+ + +++++++ +++++ +++++ +++++++++++++++ +++ +++++ ++
+   + +   + +         + +             + +   +   + ++
+ +++ + + + + +++++++++ +++++ +++++++++ + +++ + + ++
+   +   +   +             +   +   +     +   + +   ++
+++ + +++++++++ +++++++++ + + + + + + +++++++ ++++++
+   + + +     +   +     +   + + +   + +s+   +     ++
+ +++ + + +++ +++++ +++ +++++ + +++ +++ + + +++++ ++
+   +   +   +     +   +     + + +   +   + +       ++
+++ +++++++ +++++ +++ +++++ +++ +++++ +++ +++++++ ++
+ + +       +   + +   +   +   +     +   + +   +   ++
+ + + +++++++ + + + +++++ +++ + +++ +++ + +++ + ++++
+ + + +     + +   +   +     + +   + +   +   + +   ++
+ + + + +++++ +++++++ + +++++ + +++ + +++++ + +++ ++
+ + + + +   + e       +     + + +   +   +   +     ++
+ + + + + + + +++ +++++ +++ + +++ + +++ + +++ ++++++
+     +   +       +       +       +   +   +       ++
++++++++++++++++++++++++++++++++++++++++++++++++++++