++++++++++++++++++++++++++++++++++++++++++++++++++++
++       +       +   +       +       +     +       +
++ +++++++ +++++ + + +++++ + + + +++ + +++ + + +++++
++ +     + + +   + +   +   + + + + +   +   + +     +
++ + +++ + + + + + +++ + +++ + + + +++++ +++ +++++ +
++   +   + + + + +   +   + + + + +       +   +   + +
++++++ +++ + + + +++ +++++ + + + +++++++ +++ +++ + +
++     +     + +   + +     + + +       +   +     + +
++ +++++ +++++ +++ + + +++ + +++++ +++ +++ +++++ + +
++ +     +     +   + + +   +     + +   + + +   + + +
++ + +++++ +++++ +++ + +++ +++++ +++ +++ + + + +++ +
++ + + +   +   + + + +   +   +   +   +   + + + +   +
++ + + + +++ +++ + + +++ +++++ +++ +++++ + + + + + +
++     + +       + +   + +     +     +   + + + + + +
++ +++++ +++++++ + +++ + + +++++++++ + + + + + + + +
++ + +   +     +     + +             + + + + +   + +
++ + + + + +++ +++++ + + +++++++++++++ +++ + +++++ +
++ + + + + + +   +   + +   +      s+   +   +   +   +
++ + + +++ + +++ +++ + +++++ +++++++ + + +++++ + +++
++   + +   +   +   + + +     +   +   +   +     + + +
++++++ + +++ +++++ + + + +++++ + + +++++++ +++++ + +
++     + +   +     + +   +   + + + + +     +   +   +
++ +++ + + + + +++++ +++++++ + + + + + +++ +++ +++ +
++ + + + + + + +   + +       + +   +     +   +   + +
++ + + + + + + +++ + + + +++++ +++++++++ +++ + + + +
++ +   + + + +   +   + + +   +   +     +   + + +   +
++ +++++ + + +++ +++++ + + + +++ + +++ +++++ + +++++
++     + + + + +       + + +     +   +   +   +   + +
++ +++ + + + + +++++++++ + +++++++++ +++ + +++++ + +
++   +     +           +             +     +       +
+++++++++++++++++++++++++++++++++++++e++++++++++++++
++++++++++++++++++++++++++++++++++++++++++++++++++++