++++++++++++++++++++++++++++++++++++++++++++++++++++
+   +       +               +       +           + ++
+ + + + +++++ +++++++ +++++ + + +++++ +++++ +++ + ++
+ + + +       +     + +     + +     +     + +     ++
+ +++ +++++++++ +++ + + +++ + +++++ +++++ + +++++ ++
+   +   +     + + + + + +   + +   +       +     + ++
+++ +++ +++ + + + + +++ + +++ + + +++++++++++++ ++++
+   +   +   + + +       + +   + +         +   +   ++
+ +++ +++ + +++ +++++ +++++ +++ +++++++++ + + +++ ++
+   +   + + +   +   + +   +   +     + +   + +     ++
+++ +++ + + + +++ + +++ + +++ +++++ + + +++ +++++ ++
+     +   + +   + +   + +   + + +   +       +     ++
+ +++ +++++ +++ + +++ + +++ + + + +++++ +++++ ++++++
+   + + +   + + + + +   + +   + +     + +   + +   ++
+ + + + + +++ + + + +++++ +++++ +++++ +++ + +++ + ++
+ + + + + +   + + +           +     +     + +   + ++
+++ + + + e +++ + +++ +++++ + + +++ +++++++ + +++ ++
+   +   + + +   +   +   +   +   + +       +   + + ++
+ +++ +++ + + +++++ +++ + +++++++ + +++++ +++++ + ++
+   + +   + +     + +   + +         +   +       + ++
+ + + + +++ +++ + + +++++ +++++ +++++ + +++++ +++ ++
+ + + + +     + + + +     +   +     + + +     +   ++
+++ + + + + +++ +++ + +++ + + +++++++ + +++++++ + ++
+   + + + + +   +   +   + + +         +         + ++
+ +++++ +++ + +++ +++++ +++ + +++++ +++++++++++++ ++
+       +   + +   +   + +   + +s+   +       +   + ++
+ +++++++ + + + +++ + + + +++++ +++++ +++++ + + ++++
+ +       + + +   + +   + +   +       +   +   +   ++
+ +++++++ + + +++ + +++ + + + +++++++++ + +++++++ ++
+         + +       +   +   +           +         ++
++++++++++++++++++++++++++++++++++++++++++++++++++++
++++++++++++++++++++++++++++++++++++++++++++++++++++