++++++++++++++++++++++++++++++++++++++++++++++++++++
++++++++++++++++++++++++++++++++++++++++++++++++++++
+   +       + +         +       +       +         ++
+ + + + +++ + + +++++ +++ +++ + + + +++++ +++++++ ++
+ + + +   + + +     + +  e+   + + +       + +   + ++
+ + +++++ + + +++++ + + +++ +++++ +++++++++ + + + ++
+ +   +   +   +     + +   +       +         + +   ++
+ +++ + +++ +++ +++++ +++ +++++++++ +++++++ + ++++++
+ +   + +   +   +   +   +     +   + +   +   +  s+ ++
+ + +++ + +++ +++ +++++ +++++ + +++ + +++ +++++++ ++
+ +     + + + +   +     +   + +   + + +   +       ++
+ +++++++ + + + + + +++ + + + +++ + + + +++ +++ + ++
+   +   +   + + + + +   + + + +   +   +     +   + ++
+ + + + +++ + + + + + +++++ + + +++++ +++++++ +++ ++
+ +   +   + + + + + + +     + +     + +   +   +   ++
+ +++++++ +++ +++ + + + +++++ + +++ + +++ + +++++ ++
+     + +         + +   +     +   +       +     + ++
+++++ + +++++++++++ +++ + +++++++++++++++ +++++ + ++
+   + +     +     + + + + +       +     +   + + + ++
+ +++ + +++++ +++ + + + + + +++++ + +++ +++ + + ++++
+   +   +   + +   + +   + + +   +   + +   +   +   ++
+ + +++ + + + + +++ +++++ + + +++++++ +++ +++ +++ ++
+ +   + + +   +     +   +   + +           + + +   ++
+ + + + + +++++++++++ + +++++ + +++++++++++ + + ++++
+ + + + +       +   + +     +   +         + + +   ++
+ + +++ +++++++ + + + +++++ + +++++ +++++ + + +++ ++
+ + +   +     +   + +   +   +       +   + +     + ++
+ + + +++ +++ +++++ +++ + +++++++++++++ + +++++ + ++
+ + + +   +     + +   + + +   +         +     + + ++
+ + + +++++ +++ + + +++ + + + + + +++++++++++ +++ ++
+ +         +     +     +   +   +                 ++
++++++++++++++++++++++++++++++++++++++++++++++++++++