++++++++++++++++++++++++++++++++++++++++++++++++++++
++     +     +   +         +           +   +   +   +
++++ + +++ + + + + +++++ + +++ +++++++ + + + + + + +
++   +     +   + +   + + +     +     +   +   + + + +
++ +++++++ +++++++++ + + +++++++ +++ +++++++++ + +++
++   +     +       +   +   +       + +   +   + +   +
++++ + +++++ +++ +++++ +++ +++++++ +++ + + + + + + +
++   +   +   + + +       +     +s+     + + +   + + +
++ +++ +++ +++ + + +++++++++++ + + +++++ + +++++ + +
++ +   +   +   +   +           + + +     + +     + +
++ +++ + +++ + +++++ +++++++++++ + + + +++ + +++++ +
++   + + +   + +   + +     +     + + + +   + + +   +
++ + +++ + +++++ + + + +++ + +++++ + +++ +++ + + + +
++ +       +     + + +   +   +   + + +   +   + + + +
++ +++++++++ +++++ + +++ +++++ + + + + +++ +++ + + +
++ +     +   +   +     + +   + +   +   +       + + +
++ + +++ + +++ +++++ +++ +++ + +++++++++++++++ + +++
++ +   + + +   +     +   +   + +   +         + +   +
++ +++ + + + +++ +++++ +++ +++ +e+ + +++++++ + +++ +
++ +   + + +     +   +   +   +   +   +   +   + + + +
++ + +++ + +++ +++++ +++ +++ +++++++++ + + +++ + + +
++ +   + +   +     + +   +     + +     + +   +   + +
++ + +++ +++ +++++ + + +++ +++ + + +++ +++++ + +++ +
++ + +     + + +     +   +   +   +   + +     + +   +
++ + + +++++ + + +++++++ +++ +++++++ + + +++++ + +++
++ + +   +   +   +     + +   +     + +   +     +   +
++ +++++ + +++++++ + + + + +++ + +++ +++++++ +++++ +
++       +         + + + +     + +   +     +   +   +
++++++++ +++++++++++ +++ + +++++ + +++ +++ +++++ + +
++                 +     +     +       +         + +
++++++++++++++++++++++++++++++++++++++++++++++++++++
++++++++++++++++++++++++++++++++++++++++++++++++++++