++++++++++++++++++++++++++++++++++++++++++++++++++++
++     +         +     +   +       +     +         +
++++ +++ +++++++ + + + +++ + +++++ +++ + +++++++ + +
++   +   + +     + + +   + + +   +     + +       + +
++ +++ +++ + +++++ + +++ + + +++ +++++++ + +++++++ +
++ +   +   +       + +     +   +      e+   +     + +
++ + +++ + +++++++++ + +++++++ + + +++++++++ +++ + +
++       + +   +     + +   +   + +       +   + +   +
++ +++++++++ + + +++++ + + + +++ +++++ + + +++ +++++
++ +         +   +     + +   + +   +   + + +       +
++++ +++++++++ +++++ +++ +++++ +++ + +++ + +++ + + +
++   +     +   +   +   +     +   + + +   +   + + + +
++ +++ + +++ +++ + +++ +++++ + + + + +++++++ +++ + +
++   + +   +   + +   +     + + +   +     +   +   + +
++ + +++ + + +++ +++ +++++++ + +++++++++ + +++ +++ +
++ +   + +   +   + +     +s  +     +     + +   + + +
++ +++ + +++++ +++ +++++ +++++++++++ +++ + + +++ + +
++   + + +   + +     + +   +     +   +   + +   +   +
++++++ + +++ + +++ + + + + + +++ + +++ +++ +++ + +++
++     +   + +     +   + +   +   + +     + +   + + +
++ +++++++ + +++++++++ + +++++ +++ + +++++ + +++ + +
++ + +     +   +       + +   + +   + +   + + +     +
++ + + +++++++ + +++++++ +++ + + +++++ + + + +++++ +
++ +         + + + +   +   +   + +   + + + +   +   +
++ + +++++++ + + + + + +++ +++ + + + + + + +++ + +++
++ +   +   +   + +   +   +   +   + + + + +     + + +
++ +++++ + +++ + +++++ + +++ +++++ + + + +++++++ + +
++   +   + +   +     + +   +   +   + + + +     +   +
++ + + +++ +++++++++ +++ + +++ + +++ + + + +++ +++ +
++ +     +               +   +     +   +     +     +
++++++++++++++++++++++++++++++++++++++++++++++++++++
++++++++++++++++++++++++++++++++++++++++++++++++++++