++++++++++++++++++++++++++++++++++++++++++++++++++++
+ +       +           +                   +     + ++
+ + + +++ + +++++++++ +++++++ +++++++++++ +++ + + ++
+   + +   +   +     + +     + +   +           +   ++
+++++ + +++++ + + +++ + +++ + + +++ +++++++++++++ ++
+     +       + +     + +     +         +   +     ++
+ + +++++++++++ +++++++ +++++++++ +++++++ + + ++++++
+ + +     +   +   +       +     +   +   + + + +   ++
+ +++ +++ + +++++ +++++ + + +++ +++++ + + + + +++ ++
+     + + +           + + +   +       +   + +   + ++
+ +++++ + + +++++++++ +++ + +++++ +++++++++ +++ + ++
+       + + +     + +   +   +   +   +   + +   +   ++
+ +++++ + +++ +++ + +++ +++ + + +++ + + + +++ +++ ++
+ +   + +   + +   +   +   + + +   +   +     +   + ++
+ + + +++++ + + +++++ +++ +++ +++ +++++++++ +++ ++++
+ + +     + + + +       +   + +   + +     +   +   ++
+ + +++++ + + + +++ +++++++ + + +++ + + +++++ +++ ++
+ + +       + +   + +       + + +   + +     + + + ++
+ + +++ +++++ +++ + + +++++++ + + +++ +++++ + + + ++
+ +   +   +   + + +   +       + +         +     + ++
+ +++ + +++ +++ + + +++++++ +++ +++ +++++ +++++++ ++
+ +   + +   +   + +   +     + +   + +   + +       ++
+ + +++ + +++++ + +++ + +++++ +++ +++ + + + ++++++++
+ + +   + +   + + +   +   +     +   + + + +       ++
+ + +++++ + + + + +++ +++ + +++ e++ + + +++++ +++ ++
+ +         +   +   +     + +   +   + + +   + +   ++
+ +++++++++++ +++++ +++++++ +++++ +++ + + + +++ ++++
+ +   +     + +   +       +       +   +   +   +   ++
+ +++ + +++ +++ + +++++++ + +++++++ +++++++++ +++ ++
+     +  s+     +         +         +             ++
++++++++++++++++++++++++++++++++++++++++++++++++++++
++++++++++++++++++++++++++++++++++++++++++++++++++++