++++++++++++++++++++++++++++++++++++++++++++++++++++
+ +                 +       +       +             ++
+ + +++++++++ +++++++ + +++++ +++++ + +++++++++++ ++
+ + + +       +       + +     +   + +   +   +     ++
+ + + + +++++ + +++++++ + +++++ + + +++ + + + ++++++
+     +   +   +   +   + +   +   + +     + + +     ++
+++++++ + +++++++ +++ + + +++ +++ + +++++ + + +++ ++
+     + +       +   + +   +   +   + +     + + + + ++
+ +++ +++++++++ +++ + +++++ +++ +++++ +++++ + + + ++
+ + +           +     +     + + +     +   + + + + ++
+ + + +++++++++++ +++++ +++++ + + +++++++ + + + + ++
+ + + +           +     +   + + + +     + + +   + ++
+ + + + +++++++++++ +++++ + + + + + +++ + + +++++ ++
+ +   +   +     + +       +   + + +   + + +   +   ++
+ + +++++ + +++ + +++++++ +++++ + +++ + + +++ + ++++
+ +   +   + +   +       + +   + + +   + + +   +   ++
+ +++++ +++ + +++ +++++ + + + + + + +++ + + +++++ ++
+ +   +     + + +   +   + +s+   +     + + +   +   ++
+ + + +++++++ + +++ + +++ +++++++++++++ + +++ + + ++
+   e   +     +     + +   +       +     +   +   + ++
+++++++ + +++++++++++ + +++ +++ + + +++++ +++++++ ++
+       +   +         + +     + + +   +   +     + ++
+ +++++++++ + +++++++ + +++++++ + + + + + + + +++ ++
+   +     + +   + +   +       + + + + + + + +     ++
+ + + +++ + + + + + +++++++++ + + +++ + + + ++++++++
+ + + + + + + + + + +     +   + +   + + + +   +   ++
+++ + + + + + + + + + +++ + +++ +++ + +++ +++ +++ ++
+   + + + + + + +   +   + +   + +   +   + +   +   ++
+ +++ + + + +++ + +++++++ +++ + + +++++ + + +++ + ++
+       +       +           +   +       +       + ++
++++++++++++++++++++++++++++++++++++++++++++++++++++
++++++++++++++++++++++++++++++++++++++++++++++++++++