++++++++++++++++++++++++++++++++++++++++++++++++++++
+           +             +   +                   ++
+++ + +++++ +++++++ +++++ + + +++++++ +++ +++++++ ++
+   + +   +   +     + +   + +       +   +       + ++
+ + +++ + +++ + +++++ + +++ +++++++ +++ +++++++ + ++
+ + +   + + + + +   +   +   +   +s  + + +       + ++
+ + + +++ + + + + +++ +++ +++++ +++++ + + +++++++ ++
+ + + +   +   + +   +   +     +         + +   +   ++
+ + + + +++ +++ + + +++ +++++ + +++++++++ + + + ++++
+ + + +   + +   + +       + + + + +     + + + +   ++
+ +++ +++ + + +++ +++++++ + + + + + +++ + + + +++ ++
+       + + + +   +   + +   + + + + +   +   +   + ++
+ +++++++ + + +++++ + + +++ + + + + + +++ +++++ + ++
+   +   + + +       + +   + + +   + +   +     + + ++
+++ + + + + + +++++++ +++ + + + +++ +++ +++++++ + ++
+   + + + + + +     + +   + + + +   +       +   + ++
+++++ + + + +++ +++ + + +++ + + + +++++++++ + ++++++
+     + + +     +     +     + + + +   + +   +     ++
+ +++++ + +++++++ +++++++++++ + + + + + + +++ +++ ++
+   +     +     + + +   +     + + + + +     +   + ++
+ + +++ +++ +++ + + + + + +++++++ + + +++++ +++ + ++
+ +   + +     + +   + + + +     +   +     +   + + ++
+ +++ + + +++++ +++++ + + +++ + +++++++++ +++ + + ++
+   + + + + +   +     + +   + +           + + + + ++
+++ + +++ + + +++ +++++ +++ + +++++++++++++ + +++ ++
+   + +   + +     +   +   + + +   +   +     +     ++
+ +++ + +++ +++++++ + + +++ + +++ + + + + +++++++ ++
+ + + +       +     +   +   + +   + +   + +   +   ++
+ + + +++++++ + +++++++++ +++ + +++ +++++ + + + ++++
+   +         +               +         +   +     ++
+++++++++++++++++++++++++++++++++++++++++e++++++++++
++++++++++++++++++++++++++++++++++++++++++++++++++++